Rank,Release Group,Worldwide,Domestic,Foreign,filename,Year,Domestic %,Foreign %
1,Avengers: Endgame,2797800564,858373000,1939427564,movies-2019.csv,2019,0.306802783245132,0.693197216754868
2,Star Wars: Episode VII - The Force Awakens,2068223624,936662225,1131561399,movies-2015.csv,2015,0.4528824707980417,0.5471175292019583
3,Avengers: Infinity War,2048359754,678815482,1369544272,movies-2018.csv,2018,0.3313946589091205,0.6686053410908794
4,Jurassic World,1670400637,652270625,1018130012,movies-2015.csv,2015,0.39048753368022093,0.6095124663197791
5,The Lion King,1656943394,543638043,1113305351,movies-2019.csv,2019,0.32809693135479556,0.6719030686452044
6,The Avengers,1518812988,623357910,895455078,movies-2012.csv,2012,0.41042440045291473,0.5895755995470853
7,Furious 7,1515047671,353007020,1162040651,movies-2015.csv,2015,0.23300060239490641,0.7669993976050936
8,Frozen II,1450026933,477373578,972653355,movies-2019.csv,2019,0.329217042205105,0.6707829577948949
9,Avengers: Age of Ultron,1402805868,459005868,943800000,movies-2015.csv,2015,0.3272055517235689,0.6727944482764311
10,Black Panther,1346913161,700059566,646853595,movies-2018.csv,2018,0.5197510769589992,0.4802489230410007
11,Harry Potter and the Deathly Hallows: Part 2,1341511219,381011219,960500000,movies-2011.csv,2011,0.2840164238686102,0.7159835761313897
12,Star Wars: Episode VIII - The Last Jedi,1332539889,620181382,712358507,movies-2017.csv,2017,0.465412995978239,0.5345870040217611
13,Jurassic World: Fallen Kingdom,1308467944,417719760,890748184,movies-2018.csv,2018,0.3192434036427567,0.6807565963572433
14,Frozen,1280802282,400738009,880064273,movies-2013.csv,2013,0.31288046143565507,0.6871195385643449
15,Beauty and the Beast,1263521126,504014165,759506961,movies-2017.csv,2017,0.3988965080430321,0.6011034919569679
16,Incredibles 2,1242805359,608581744,634223615,movies-2018.csv,2018,0.48968387494698595,0.510316125053014
17,The Fate of the Furious,1236005118,226008385,1009996733,movies-2017.csv,2017,0.1828539232634472,0.8171460767365528
18,Iron Man 3,1214811252,409013994,805797258,movies-2013.csv,2013,0.33668933616363966,0.6633106638363603
19,Minions,1159398397,336045770,823352627,movies-2015.csv,2015,0.28984494964762314,0.7101550503523768
20,Captain America: Civil War,1153296293,408084349,745211944,movies-2016.csv,2016,0.35384172434862754,0.6461582756513724
21,Aquaman,1148461807,335061807,813400000,movies-2018.csv,2018,0.2917483236776023,0.7082516763223977
22,Spider-Man: Far from Home,1131927996,390532085,741395911,movies-2019.csv,2019,0.345014953583673,0.654985046416327
23,Captain Marvel,1128274794,426829839,701444955,movies-2019.csv,2019,0.3783030882811692,0.6216969117188308
24,Transformers: Dark of the Moon,1123794079,352390543,771403536,movies-2011.csv,2011,0.3135721655639725,0.6864278344360275
25,Skyfall,1108561013,304360277,804200736,movies-2012.csv,2012,0.2745543758356943,0.7254456241643057
26,Transformers: Age of Extinction,1104054072,245439076,858614996,movies-2014.csv,2014,0.22230711540729683,0.7776928845927031
27,The Dark Knight Rises,1081041287,448139099,632902188,movies-2012.csv,2012,0.4145439257399981,0.5854560742600019
28,Joker,1074251311,335451311,738800000,movies-2019.csv,2019,0.3122652097931673,0.6877347902068327
29,Star Wars: Episode IX - The Rise of Skywalker,1074144248,515202542,558941706,movies-2019.csv,2019,0.4796399952420543,0.5203600047579457
30,Toy Story 4,1073394593,434038008,639356585,movies-2019.csv,2019,0.4043601587249657,0.5956398412750342
31,Rogue One: A Star Wars Story,1056057273,532177324,523879949,movies-2016.csv,2016,0.5039284682810948,0.49607153171890517
32,Aladdin,1050693953,355559216,695134737,movies-2019.csv,2019,0.3384041708670612,0.6615958291329388
33,Pirates of the Caribbean: On Stranger Tides,1045713802,241071802,804642000,movies-2011.csv,2011,0.23053325062644625,0.7694667493735537
34,Despicable Me 3,1034799409,264624300,770175109,movies-2017.csv,2017,0.2557252136969475,0.7442747863030524
35,Finding Dory,1028570889,486295561,542275328,movies-2016.csv,2016,0.47278759898871686,0.5272124010112832
36,Zootopia,1023784195,341268248,682515947,movies-2016.csv,2016,0.3333400238709487,0.6666599761290513
37,The Hobbit: An Unexpected Journey,1017003568,303003568,714000000,movies-2012.csv,2012,0.29793756633113405,0.7020624336688659
38,Despicable Me 2,970766005,368065385,602700620,movies-2013.csv,2013,0.3791494377679614,0.6208505622320386
39,The Jungle Book,966550600,364001123,602549477,movies-2016.csv,2016,0.3765981036067848,0.6234018963932152
40,Jumanji: Welcome to the Jungle,962077546,404515480,557562066,movies-2017.csv,2017,0.42046036900231326,0.5795396309976868
41,The Hobbit: The Desolation of Smaug,958366855,258366855,700000000,movies-2013.csv,2013,0.2695907664711547,0.7304092335288452
42,The Hobbit: The Battle of the Five Armies,956019788,255119788,700900000,movies-2014.csv,2014,0.26685617934092387,0.7331438206590761
43,Bohemian Rhapsody,903655259,216428042,687227217,movies-2018.csv,2018,0.23950288546929155,0.7604971145307085
44,Spectre,880674609,200074609,680600000,movies-2015.csv,2015,0.22718335121207064,0.7728166487879293
45,Spider-Man: Homecoming,880166924,334201140,545965784,movies-2017.csv,2017,0.37970199843592395,0.620298001564076
46,Ice Age: Continental Drift,877244782,161321843,715922939,movies-2012.csv,2012,0.18389604168657225,0.8161039583134277
47,The Secret Life of Pets,875457937,368384330,507073607,movies-2016.csv,2016,0.42079043941548044,0.5792095605845196
48,Batman v Superman: Dawn of Justice,873634919,330360194,543274725,movies-2016.csv,2016,0.3781444477724682,0.6218555522275317
49,Wolf Warrior 2,870325439,2721100,867604339,movies-2017.csv,2017,0.003126531614572282,0.9968734683854277
50,The Hunger Games: Catching Fire,865011746,424668047,440343699,movies-2013.csv,2013,0.490939052520103,0.5090609474798969
51,Guardians of the Galaxy Vol. 2,863756051,389813101,473942950,movies-2017.csv,2017,0.4512999944240043,0.5487000055759956
52,Inside Out,857611174,356461711,501149463,movies-2015.csv,2015,0.4156449004009829,0.5843550995990171
53,Venom,856085151,213515506,642569645,movies-2018.csv,2018,0.24940919224050412,0.7505908077594958
54,Thor: Ragnarok,853977126,315058289,538918837,movies-2017.csv,2017,0.36893059475225337,0.6310694052477467
55,The Twilight Saga: Breaking Dawn - Part 2,829746820,292324737,537422083,movies-2012.csv,2012,0.35230594436023266,0.6476940556397673
56,Wonder Woman,821847012,412563408,409283604,movies-2017.csv,2017,0.501995385973369,0.49800461402663104
57,Fantastic Beasts and Where to Find Them,814037575,234037575,580000000,movies-2016.csv,2016,0.287502177034027,0.7124978229659731
58,Coco,807816196,210460015,597356181,movies-2017.csv,2017,0.2605295809147159,0.7394704190852841
59,Jumanji: The Next Level,800059707,320314960,479744747,movies-2019.csv,2019,0.4003638193467978,0.5996361806532021
60,Pirates of the Caribbean: Dead Men Tell No Tales,794861794,172558876,622302918,movies-2017.csv,2017,0.21709293024593404,0.782907069754066
61,Mission: Impossible - Fallout,791115104,220159104,570956000,movies-2018.csv,2018,0.27828959766643513,0.7217104023335649
62,Fast & Furious 6,788679850,238679850,550000000,movies-2013.csv,2013,0.30263211365169274,0.6973678863483073
63,Deadpool,782612155,363070709,419541446,movies-2016.csv,2016,0.463921633059737,0.536078366940263
64,Guardians of the Galaxy,772776600,333176600,439600000,movies-2014.csv,2014,0.4311421955581988,0.5688578044418011
65,Fast & Furious Presents: Hobbs & Shaw,759056935,173956935,585100000,movies-2019.csv,2019,0.22917508157671992,0.77082491842328
66,Maleficent,758410378,241410378,517000000,movies-2014.csv,2014,0.31831101604466705,0.681688983955333
67,The Amazing Spider-Man,757930663,262030663,495900000,movies-2012.csv,2012,0.34571851462354675,0.6542814853764533
68,The Hunger Games: Mockingjay - Part 1,755356711,337135885,418220826,movies-2014.csv,2014,0.44632672231596815,0.5536732776840319
69,Madagascar 3: Europe's Most Wanted,746921274,216391482,530529792,movies-2012.csv,2012,0.2897112313338661,0.7102887686661339
70,Suicide Squad,746846894,325100054,421746840,movies-2016.csv,2016,0.43529678788488074,0.5647032121151193
71,X-Men: Days of Future Past,746045700,233921534,512124166,movies-2014.csv,2014,0.3135485319465014,0.6864514680534985
72,Monsters University,743559607,268492764,475066843,movies-2013.csv,2013,0.3610911102114238,0.6389088897885762
73,Deadpool 2,734546611,318491426,416055185,movies-2018.csv,2018,0.43358912998919275,0.5664108700108073
74,Ne Zha,726063471,3695533,722367938,movies-2019.csv,2019,0.005089820859476899,0.9949101791405232
75,Gravity,723192705,274092705,449100000,movies-2013.csv,2013,0.37900369169238235,0.6209963083076177
76,Captain America: The Winter Soldier,714421503,259766572,454654931,movies-2014.csv,2014,0.3636040781376089,0.6363959218623911
77,The Twilight Saga: Breaking Dawn - Part 1,712205856,281287133,430918723,movies-2011.csv,2011,0.394952008089077,0.6050479919109231
78,Dawn of the Planet of the Apes,710644566,208545589,502098977,movies-2014.csv,2014,0.29345976734028806,0.7065402326597119
79,The Amazing Spider-Man 2,708982323,202853933,506128390,movies-2014.csv,2014,0.28611987410580336,0.7138801258941967
80,It,700381748,327481748,372900000,movies-2017.csv,2017,0.4675760739555994,0.5324239260444006
81,The Wandering Earth,699856699,5971413,693885286,movies-2019.csv,2019,0.008532336703402763,0.9914676632965972
82,Mission: Impossible - Ghost Protocol,694713380,209397903,485315477,movies-2011.csv,2011,0.3014162516921727,0.6985837483078273
83,The Hunger Games,694394724,408010692,286384032,movies-2012.csv,2012,0.5875774655223331,0.4124225344776669
84,Mission: Impossible - Rogue Nation,682714267,195042377,487671890,movies-2015.csv,2015,0.2856866868434727,0.7143133131565274
85,Interstellar,677896797,188020017,489876780,movies-2014.csv,2014,0.2773578778245798,0.7226421221754201
86,Doctor Strange,677718395,232641920,445076475,movies-2016.csv,2016,0.3432722524817996,0.6567277475182004
87,Man of Steel,668045518,291045518,377000000,movies-2013.csv,2013,0.4356671965577052,0.5643328034422948
88,Kung Fu Panda 2,665692281,165249063,500443218,movies-2011.csv,2011,0.24823641150196843,0.7517635884980316
89,The Hunger Games: Mockingjay - Part 2,658344137,281723902,376620235,movies-2015.csv,2015,0.4279280184430351,0.5720719815569649
90,Justice League,657924295,229024295,428900000,movies-2017.csv,2017,0.3481012887660578,0.6518987112339422
91,Big Hero 6,657827828,222527828,435300000,movies-2014.csv,2014,0.33827670178769026,0.6617232982123098
92,Fantastic Beasts: The Crimes of Grindelwald,654855901,159555901,495300000,movies-2018.csv,2018,0.24365039813545178,0.7563496018645482
93,Thor: The Dark World,644783140,206362140,438421000,movies-2013.csv,2013,0.32004890822672566,0.6799510917732744
94,Moana,643331111,248757044,394574067,movies-2016.csv,2016,0.38667031602642327,0.6133296839735767
95,Sing,634151679,270395425,363756254,movies-2016.csv,2016,0.42638919670825315,0.5736108032917469
96,The Martian,630161890,228433663,401728227,movies-2015.csv,2015,0.36249996488997455,0.6375000351100255
97,Fast Five,626137675,209837675,416300000,movies-2011.csv,2011,0.33513024911014977,0.6648697508898502
98,Men in Black 3,624026776,179020854,445005922,movies-2012.csv,2012,0.2868800841328001,0.7131199158671999
99,Ant-Man and the Wasp,622674139,216648740,406025399,movies-2018.csv,2018,0.3479327732285988,0.6520672267714012
100,How to Train Your Dragon 2,621537519,177002924,444534595,movies-2014.csv,2014,0.2847823640393944,0.7152176359606056
101,Logan,619021436,226277068,392744368,movies-2017.csv,2017,0.36553995522701094,0.6344600447729891
102,Life of Pi,609016565,124987023,484029542,movies-2012.csv,2012,0.20522762463776334,0.7947723753622367
103,Transformers: The Last Knight,605425157,130168683,475256474,movies-2017.csv,2017,0.21500375644284633,0.7849962435571537
104,The Croods,587204668,187168425,400036243,movies-2013.csv,2013,0.3187447838885368,0.6812552161114632
105,The Hangover Part II,586764305,254464305,332300000,movies-2011.csv,2011,0.43367379854505633,0.5663262014549436
106,Ready Player One,582890172,137690172,445200000,movies-2018.csv,2018,0.23621975221774713,0.7637802477822528
107,Operation Red Sea,579330426,1543547,577786879,movies-2018.csv,2018,0.0026643637736368433,0.9973356362263631
108,Fifty Shades of Grey,569651467,166167230,403484237,movies-2015.csv,2015,0.2916998193212763,0.7083001806787237
109,Kong: Skull Island,566652812,168052812,398600000,movies-2017.csv,2017,0.29657103686975084,0.7034289631302492
110,The Smurfs,563749323,142614158,421135165,movies-2011.csv,2011,0.2529744199799243,0.7470255800200757
111,Cars 2,559852396,191452396,368400000,movies-2011.csv,2011,0.3419694143811434,0.6580305856188566
112,Puss in Boots,554987477,149260504,405726973,movies-2011.csv,2011,0.26894391348581725,0.7310560865141827
113,The Mermaid,553810228,3232685,550577543,movies-2016.csv,2016,0.005837170995693492,0.9941628290043065
114,Ted,549368315,218815487,330552828,movies-2012.csv,2012,0.398303799155217,0.6016962008447829
115,American Sniper,547426372,350126372,197300000,movies-2014.csv,2014,0.639586234621521,0.3604137653784791
116,Detective Chinatown 2,544185156,1983984,542201172,movies-2018.csv,2018,0.0036457885301083076,0.9963542114698917
117,X-Men: Apocalypse,543934105,155442489,388491616,movies-2016.csv,2016,0.285774485495812,0.7142255145041879
118,Sherlock Holmes: A Game of Shadows,543848418,186848418,357000000,movies-2011.csv,2011,0.3435670893134785,0.6564329106865214
119,Cinderella,542351353,201151353,341200000,movies-2015.csv,2015,0.3708875286976559,0.6291124713023442
120,World War Z,540007876,202359711,337648165,movies-2013.csv,2013,0.37473473997997764,0.6252652600200224
121,Brave,538983207,237283207,301700000,movies-2012.csv,2012,0.4402423005360907,0.5597576994639093
122,The Revenant,532950503,183637894,349312609,movies-2015.csv,2015,0.34456838480552104,0.6554316151944789
123,The Meg,530243742,145443742,384800000,movies-2018.csv,2018,0.2742960085703378,0.7257039914296621
124,Ralph Breaks the Internet,529323962,201091711,328232251,movies-2018.csv,2018,0.3799029052835511,0.6200970947164489
125,Hotel Transylvania 3: Summer Vacation,528583774,167510016,361073758,movies-2018.csv,2018,0.31690343941583043,0.6830965605841696
126,The Boss Baby,527965936,175003033,352962903,movies-2017.csv,2017,0.331466522870521,0.6685334771294791
127,Dunkirk,525245546,188045546,337200000,movies-2017.csv,2017,0.3580145465907482,0.6419854534092517
128,Godzilla,524976069,200676069,324300000,movies-2014.csv,2014,0.38225755582013016,0.6177424441798699
129,How to Train Your Dragon: The Hidden World,521799505,160799505,361000000,movies-2019.csv,2019,0.3081633912243746,0.6918366087756255
130,Kung Fu Panda 3,521170825,143528619,377642206,movies-2016.csv,2016,0.2753964959569638,0.7246035040430362
131,Ant-Man,519311965,180202163,339109802,movies-2015.csv,2015,0.3470017545234106,0.6529982454765894
132,Dr. Seuss' the Grinch,511595957,270620950,240975007,movies-2018.csv,2018,0.5289739809261237,0.4710260190738763
133,Rio 2,498781117,131538435,367242682,movies-2014.csv,2014,0.2637197570572825,0.7362802429427175
134,Oz the Great and Powerful,493311825,234911825,258400000,movies-2013.csv,2013,0.47619337930932426,0.5238066206906757
135,Maleficent: Mistress of Evil,491730089,113929605,377800484,movies-2019.csv,2019,0.23169134358178353,0.7683086564182164
136,War for the Planet of the Apes,490719763,146880162,343839601,movies-2017.csv,2017,0.2993157665019495,0.7006842334980505
137,Teenage Mutant Ninja Turtles,485004754,191204754,293800000,movies-2014.csv,2014,0.39423274189184543,0.6057672581081546
138,Rio,483866518,143619809,340246709,movies-2011.csv,2011,0.29681700150205476,0.7031829984979453
139,Rise of the Planet of the Apes,481800873,176760185,305040688,movies-2011.csv,2011,0.3668739408863628,0.6331260591136372
140,Hotel Transylvania 2,474800000,169700110,305099890,movies-2015.csv,2015,0.3574138795282224,0.6425861204717775
141,San Andreas,473990832,155190832,318800000,movies-2015.csv,2015,0.32741315131597315,0.6725868486840269
142,It Chapter Two,473093228,211593228,261500000,movies-2019.csv,2019,0.44725482310222375,0.5527451768977762
143,Wreck-It Ralph,471222889,189422889,281800000,movies-2012.csv,2012,0.40198151113156133,0.5980184888684387
144,The Lego Movie,468060692,257760692,210300000,movies-2014.csv,2014,0.5506992926464331,0.44930070735356686
145,Bumblebee,467989645,127195589,340794056,movies-2018.csv,2018,0.2717914602576303,0.7282085397423698
146,Star Trek Into Darkness,467365246,228778661,238586585,movies-2013.csv,2013,0.4895072172311246,0.5104927827688753
147,The Eight Hundred,461132912,372755,460760157,movies-2020.csv,2020,0.0008083461195239952,0.999191653880476
148,Lucy,458863600,126663600,332200000,movies-2014.csv,2014,0.27603758502526676,0.7239624149747332
149,Thor,449326618,181030624,268295994,movies-2011.csv,2011,0.40289316668081304,0.597106833319187
150,La La Land,447407695,151101803,296305892,movies-2016.csv,2016,0.3377273227274287,0.6622726772725712
151,Les Misérables,441809770,148809770,293000000,movies-2012.csv,2012,0.33681864934765926,0.6631813506523407
152,Terminator Genisys,440603537,89760956,350842581,movies-2015.csv,2015,0.20372273134974855,0.7962772686502514
153,Warcraft,439048914,47365290,391683624,movies-2016.csv,2016,0.10788157877097038,0.8921184212290296
154,A Star Is Born,436188866,215288866,220900000,movies-2018.csv,2018,0.4935679995096436,0.5064320004903564
155,The Greatest Showman,434993183,174340174,260653009,movies-2017.csv,2017,0.4007882900546513,0.5992117099453488
156,Pokémon Detective Pikachu,433005346,144105346,288900000,movies-2019.csv,2019,0.3328026947731957,0.6671973052268043
157,The Secret Life of Pets 2,430051293,158874395,271176898,movies-2019.csv,2019,0.36943126921374003,0.63056873078626
158,Rampage,428028233,101028233,327000000,movies-2018.csv,2018,0.2360317035441912,0.7639682964558088
159,The Intouchables,426588510,10198820,416389690,movies-2011.csv,2011,0.023907863810021513,0.9760921361899785
160,Bad Boys for Life,426505244,206305244,220200000,movies-2020.csv,2020,0.4837109200936343,0.5162890799063657
161,Django Unchained,425368238,162805434,262562804,movies-2012.csv,2012,0.38273998727662406,0.6172600127233759
162,The Captain,416953262,706572,416246690,movies-2019.csv,2019,0.001694607200362903,0.9983053927996371
163,Jason Bourne,415484914,162434410,253050504,movies-2016.csv,2016,0.39095140287091146,0.6090485971290885
164,The Wolverine,414828246,132556852,282271394,movies-2013.csv,2013,0.3195463502743253,0.6804536497256747
165,Kingsman: The Secret Service,414351546,128261724,286089822,movies-2015.csv,2015,0.3095480763573644,0.6904519236426355
166,Pacific Rim,411002906,101802906,309200000,movies-2013.csv,2013,0.24769388370212642,0.7523061162978736
167,Kingsman: The Golden Circle,410902662,100234838,310667824,movies-2017.csv,2017,0.24393815681826855,0.7560618431817314
168,The Mummy,409231607,80227895,329003712,movies-2017.csv,2017,0.196045206742792,0.803954793257208
169,Ice Age: Collision Course,408579038,64063008,344516030,movies-2016.csv,2016,0.15679465180981703,0.843205348190183
170,"My People, My Country",405979670,2356683,403622987,movies-2019.csv,2019,0.005804928606400414,0.9941950713935996
171,Alita: Battle Angel,404980543,85838210,319142333,movies-2019.csv,2019,0.21195638033405473,0.7880436196659453
172,Prometheus,403354469,126477084,276877385,movies-2012.csv,2012,0.3135631156227502,0.6864368843772498
173,Snow White and the Huntsman,396592829,155332381,241260448,movies-2012.csv,2012,0.39166714484391246,0.6083328551560876
174,Mamma Mia! Here We Go Again,395044706,120634935,274409771,movies-2018.csv,2018,0.3053703369967449,0.6946296630032551
175,Solo: A Star Wars Story,392924807,213767512,179157295,movies-2018.csv,2018,0.5440417815106289,0.4559582184893712
176,The Wolf of Wall Street,392000694,116900694,275100000,movies-2013.csv,2013,0.2982155281592435,0.7017844718407565
177,Independence Day: Resurgence,389681935,103144286,286537649,movies-2016.csv,2016,0.26468839516514925,0.7353116048348508
178,Monster Hunt,387053506,32766,387020740,movies-2015.csv,2015,8.465496240718718e-05,0.9999153450375928
179,Godzilla: King of the Monsters,386600138,110500138,276100000,movies-2019.csv,2019,0.2858253971963145,0.7141746028036855
180,Home,386041607,177397510,208644097,movies-2015.csv,2015,0.45952950869360565,0.5404704913063944
181,1917,384792488,159227644,225564844,movies-2019.csv,2019,0.4138013317973089,0.5861986682026911
182,Cars 3,383930656,152901115,231029541,movies-2017.csv,2017,0.3982519046356121,0.6017480953643879
183,Fifty Shades Darker,381545846,114581250,266964596,movies-2017.csv,2017,0.3003079477898444,0.6996920522101556
184,Taken 2,376141306,139854287,236287019,movies-2012.csv,2012,0.3718131584304118,0.6281868415695883
185,G.I. Joe: Retaliation,375740705,122523060,253217645,movies-2013.csv,2013,0.3260840743884802,0.6739159256115198
186,Spider-Man: Into the Spider-Verse,375540831,190241310,185299521,movies-2018.csv,2018,0.5065795628491859,0.49342043715081413
187,Mad Max: Fury Road,374736354,153636354,221100000,movies-2015.csv,2015,0.4099851865453118,0.5900148134546882
188,Once Upon a Time... In Hollywood,374343626,142502728,231840898,movies-2019.csv,2019,0.38067357930651663,0.6193264206934834
189,The Adventures of Tintin,373993951,77591831,296402120,movies-2011.csv,2011,0.20746814431766036,0.7925318556823396
190,Penguins of Madagascar,373515621,83850911,289664710,movies-2014.csv,2014,0.22449104210289508,0.775508957897105
191,Fifty Shades Freed,371985018,100407760,271577258,movies-2018.csv,2018,0.26992420431298125,0.7300757956870187
192,Captain America: The First Avenger,370569774,176654505,193915269,movies-2011.csv,2011,0.4767105074252494,0.5232894925747505
193,Edge of Tomorrow,370541256,100206256,270335000,movies-2014.csv,2014,0.2704321162013873,0.7295678837986127
194,Gone Girl,369330363,167767189,201563174,movies-2014.csv,2014,0.4542469447604014,0.5457530552395986
195,Shazam!,365971656,140371656,225600000,movies-2019.csv,2019,0.3835588185550632,0.6164411814449369
196,The Nun,365550119,117450119,248100000,movies-2018.csv,2018,0.32129689718415877,0.6787031028158412
197,Night at the Museum: Secret of the Tomb,363204635,113746621,249458014,movies-2014.csv,2014,0.313175025973994,0.6868249740260061
198,The Hangover Part III,362000072,112200072,249800000,movies-2013.csv,2013,0.3099448886297459,0.6900551113702541
199,Monster Hunt 2,361682618,706153,360976465,movies-2018.csv,2018,0.0019524106629862981,0.9980475893370137
200,Noah,359200044,101200044,258000000,movies-2014.csv,2014,0.28173728174710355,0.7182627182528964
201,Hotel Transylvania,358375603,148313048,210062555,movies-2012.csv,2012,0.4138480598524448,0.5861519401475552
202,Your Name.,357986087,5017246,352968841,movies-2016.csv,2016,0.014015198305737508,0.9859848016942625
203,The Legend of Tarzan,356700357,126643061,230057296,movies-2016.csv,2016,0.3550404660794887,0.6449595339205113
204,Tenet,353700000,56300000,297400000,movies-2020.csv,2020,0.15917444161718972,0.8408255583828103
205,The Great Gatsby,353641895,144840419,208801476,movies-2013.csv,2013,0.40956804340164504,0.5904319565983549
206,Dumbo,353284621,114766307,238518314,movies-2019.csv,2019,0.32485508900768145,0.6751449109923185
207,Murder on the Orient Express,352789811,102826543,249963268,movies-2017.csv,2017,0.29146687289106543,0.7085331271089346
208,X-Men: First Class,352616690,146408305,206208385,movies-2011.csv,2011,0.41520526155469273,0.5847947384453073
209,The Angry Birds Movie,352333929,107509366,244824563,movies-2016.csv,2016,0.3051348653964007,0.6948651346035993
210,Now You See Me,351723989,117723989,234000000,movies-2013.csv,2013,0.3347056006464205,0.6652943993535795
211,Peter Rabbit,351266433,115253424,236013009,movies-2018.csv,2018,0.3281082767165515,0.6718917232834485
212,Mary Poppins Returns,349537494,171958438,177579056,movies-2018.csv,2018,0.4919599211865952,0.5080400788134047
213,The Lorax,348840316,214030500,134809816,movies-2012.csv,2012,0.6135486358176558,0.3864513641823441
214,The Maze Runner,348319861,102427862,245891999,movies-2014.csv,2014,0.2940626517992323,0.7059373482007677
215,The Smurfs 2,347545360,71017784,276527576,movies-2013.csv,2013,0.2043410506185437,0.7956589493814563
216,Trolls,346864462,153707064,193157398,movies-2016.csv,2016,0.44313292608223437,0.5568670739177656
217,xXx: Return of Xander Cage,346118277,44898413,301219864,movies-2017.csv,2017,0.12971985585147242,0.8702801441485276
218,Titanic 2012 3D Release,343550770,57884114,285666656,movies-2012.csv,2012,0.1684878016719334,0.8315121983280667
219,Star Trek Beyond,343471816,158848340,184623476,movies-2016.csv,2016,0.462478528369268,0.537521471630732
220,Alvin and the Chipmunks: Chipwrecked,342695435,133110742,209584693,movies-2011.csv,2011,0.3884228630007867,0.6115771369992133
221,A Quiet Place,340939361,188024361,152915000,movies-2018.csv,2018,0.5514891576276522,0.44851084237234784
222,300: Rise of an Empire,337580051,106580051,231000000,movies-2014.csv,2014,0.31571785916935,0.68428214083065
223,Journey 2: The Mysterious Island,335260290,103860290,231400000,movies-2012.csv,2012,0.30979001420060814,0.6902099857993919
224,The Great Wall,334933831,45540830,289393001,movies-2016.csv,2016,0.13596963276008986,0.8640303672399101
225,Now You See Me 2,334897606,65075540,269822066,movies-2016.csv,2016,0.19431473630778956,0.8056852636922105
226,The Good Dinosaur,332207671,123087120,209120551,movies-2015.csv,2015,0.3705125761530052,0.6294874238469947
227,22 Jump Street,331333876,191719337,139614539,movies-2014.csv,2014,0.5786288420445123,0.4213711579554878
228,John Wick: Chapter 3 - Parabellum,326709727,171015687,155694040,movies-2019.csv,2019,0.5234484096030603,0.47655159039693973
229,Taken 3,326479141,89256424,237222717,movies-2015.csv,2015,0.27339089329446625,0.7266091067055338
230,The SpongeBob Movie: Sponge Out of Water,325186032,162994032,162192000,movies-2015.csv,2015,0.5012331894993571,0.4987668105006429
231,Green Book,321752656,85080171,236672485,movies-2018.csv,2018,0.26442725308847176,0.7355727469115282
232,The Conjuring 2,320392818,102470008,217922810,movies-2016.csv,2016,0.31982617038562955,0.6801738296143705
233,The Conjuring,319494638,137400141,182094497,movies-2013.csv,2013,0.4300546070510266,0.5699453929489734
234,Sonic the Hedgehog,319104189,146066470,173037719,movies-2020.csv,2020,0.45773911792803196,0.542260882071968
235,The Expendables 2,314975955,85028192,229947763,movies-2012.csv,2012,0.26995137454222495,0.730048625457775
236,Maze Runner: The Scorch Trials,312296056,81697192,230598864,movies-2015.csv,2015,0.2616017411375826,0.7383982588624174
237,Resident Evil: The Final Chapter,312242626,26830068,285412558,movies-2016.csv,2016,0.085926986791355,0.914073013208645
238,The Lego Batman Movie,311950384,175750384,136200000,movies-2017.csv,2017,0.5633921066114155,0.4366078933885845
239,Knives Out,311398301,165363234,146035067,movies-2019.csv,2019,0.5310344772883009,0.46896552271169906
240,The Ex-File 3: The Return of The Exes,307592427,838959,306753468,movies-2017.csv,2017,0.002727502130603495,0.9972724978693965
241,The Fault in Our Stars,307166834,124872350,182294484,movies-2014.csv,2014,0.40652940414784494,0.593470595852155
242,Rise of the Guardians,306941670,103412758,203528912,movies-2012.csv,2012,0.33691338813657984,0.6630866118634202
243,Annabelle: Creation,306515884,102092201,204423683,movies-2017.csv,2017,0.33307311734617967,0.6669268826538203
244,Wonder,305937718,132422809,173514909,movies-2017.csv,2017,0.43284237676114196,0.5671576232388581
245,Skyscraper,304868961,68420120,236448841,movies-2018.csv,2018,0.22442468323300382,0.7755753167669962
246,A Good Day to Die Hard,304654182,67349198,237304984,movies-2013.csv,2013,0.22106769569964413,0.7789323043003559
247,Dangal,303723636,12391761,291331875,movies-2016.csv,2016,0.04079946217949267,0.9592005378205073
248,Passengers,303144152,100014699,203129453,movies-2016.csv,2016,0.3299245535173642,0.6700754464826357
249,Battleship,303025485,65422625,237602860,movies-2012.csv,2012,0.21589809517176417,0.7841019048282358
250,Wrath of the Titans,301970083,83670083,218300000,movies-2012.csv,2012,0.27708070338875257,0.7229192966112474
251,Alice Through the Looking Glass,299457024,77041381,222415643,movies-2016.csv,2016,0.257270241889534,0.7427297581104659
252,Real Steel,299268508,85468508,213800000,movies-2011.csv,2011,0.28559138604720813,0.7144086139527919
253,Ocean's Eight,297718711,140218711,157500000,movies-2018.csv,2018,0.47097715333048046,0.5290228466695195
254,The Divergent Series: Insurgent,297002527,130179072,166823455,movies-2015.csv,2015,0.4383096444159211,0.5616903555840789
255,Miss Peregrine's Home for Peculiar Children,296482446,87242834,209239612,movies-2016.csv,2016,0.29425969455203427,0.7057403054479657
256,Ferdinand,296069199,84410380,211658819,movies-2017.csv,2017,0.28510355107894897,0.7148964489210511
257,Pacific Rim: Uprising,290930148,59874525,231055623,movies-2018.csv,2018,0.20580378283793402,0.794196217162066
258,Divergent,288885818,150947895,137937923,movies-2014.csv,2014,0.5225174985917792,0.47748250140822074
259,Bridesmaids,288383523,169106725,119276798,movies-2011.csv,2011,0.5863952393701772,0.4136047606298228
260,Maze Runner: The Death Cure,288175335,58032443,230142892,movies-2018.csv,2018,0.2013789382772818,0.7986210617227182
261,Pitch Perfect 2,287144079,184296230,102847849,movies-2015.csv,2015,0.6418249355578737,0.35817506444212627
262,Oblivion,286168572,89107235,197061337,movies-2013.csv,2013,0.3113802273158074,0.6886197726841926
263,Elysium,286140700,93050117,193090583,movies-2013.csv,2013,0.3251900795657521,0.6748099204342479
264,John Carter,284139100,73078100,211061000,movies-2012.csv,2012,0.2571912841280908,0.7428087158719092
265,Turbo,282570682,83028128,199542554,movies-2013.csv,2013,0.29383136074959115,0.7061686392504088
266,Paddington,282370135,76271832,206098303,movies-2014.csv,2014,0.2701129565277858,0.7298870434722142
267,Split,278454358,138291365,140162993,movies-2017.csv,2017,0.4966392553281569,0.5033607446718431
268,The Bourne Legacy,276144750,113203870,162940880,movies-2012.csv,2012,0.4099439514964525,0.5900560485035475
269,Mr. Peabody & Sherman,275698039,111506430,164191609,movies-2014.csv,2014,0.4044512989807664,0.5955487010192336
270,Lincoln,275293450,182207973,93085477,movies-2012.csv,2012,0.6618681737614898,0.33813182623851024
271,Tomb Raider,274650803,58250803,216400000,movies-2018.csv,2018,0.21209041577060309,0.7879095842293969
272,Cloudy With a Chance of Meatballs 2,274325949,119793567,154532382,movies-2013.csv,2013,0.43668332302023677,0.5633166769797632
273,Neighbors,270665134,150157400,120507734,movies-2014.csv,2014,0.5547718606416444,0.44522813935835565
274,We're the Millers,269994119,150394119,119600000,movies-2012.csv,2012,0.5570273884373015,0.4429726115626985
275,Epic,268426634,107518682,160907952,movies-2013.csv,2013,0.4005514668861064,0.5994485331138936
276,Exodus: Gods and Kings,268175631,65014513,203161118,movies-2014.csv,2014,0.24243259075243864,0.7575674092475614
277,Terminator: Dark Fate,261119292,62253077,198866215,movies-2019.csv,2019,0.23840856998034446,0.7615914300196556
278,The Lone Ranger,260502115,89302115,171200000,movies-2013.csv,2013,0.34280763900899613,0.6571923609910039
279,Super 8,260095986,127004179,133091807,movies-2011.csv,2011,0.4882973434276683,0.5117026565723317
280,Mojin: The Lost Legend,259368448,1243810,258124638,movies-2015.csv,2015,0.004795533186827721,0.9952044668131723
281,Blade Runner 2049,259239658,92054159,167185499,movies-2017.csv,2017,0.35509288860425825,0.6449071113957418
282,Kung Fu Yoga,257743016,362657,257380359,movies-2017.csv,2017,0.0014070487946800467,0.99859295120532
283,Parasite,257526391,53369749,204156642,movies-2019.csv,2019,0.20723992128635857,0.7927600787136414
284,Annabelle,257047661,84273813,172773848,movies-2014.csv,2014,0.3278528684997449,0.6721471315002551
285,Lost in Hong Kong,256283912,1302281,254981631,movies-2015.csv,2015,0.005081399725161055,0.9949186002748389
286,Halloween,255485178,159342015,96143163,movies-2018.csv,2018,0.6236839892136522,0.37631601078634785
287,Get Out,255407969,176040665,79367304,movies-2017.csv,2017,0.6892528282858708,0.31074717171412924
288,Us,255184580,175084580,80100000,movies-2019.csv,2019,0.6861095603817441,0.3138904396182559
289,Baahubali 2: The Conclusion,254158390,20186659,233971731,movies-2017.csv,2017,0.07942550706274147,0.9205744929372586
290,Men in Black: International,253890701,80001807,173888894,movies-2019.csv,2019,0.31510333653377876,0.6848966634662212
291,X-Men: Dark Phoenix,252442974,65845974,186597000,movies-2019.csv,2019,0.26083504308580996,0.73916495691419
292,American Hustle,251171807,150117807,101054000,movies-2013.csv,2013,0.5976698133162692,0.4023301866837308
293,Journey to the West: The Demons Strike Back,247585244,880346,246704898,movies-2017.csv,2017,0.0035557288704976295,0.9964442711295024
294,Glass,246999039,111048468,135950571,movies-2019.csv,2019,0.44959068848846817,0.5504093115115318
295,Grown Ups 2,246984278,133668525,113315753,movies-2013.csv,2013,0.5412025659382255,0.4587974340617746
296,The Peanuts Movie,246233113,130178411,116054702,movies-2015.csv,2015,0.5286795484732388,0.47132045152676116
297,Rango,245724603,123477607,122246996,movies-2011.csv,2011,0.5025040451484624,0.4974959548515376
298,Teenage Mutant Ninja Turtles: Out of the Shadows,245623848,82051601,163572247,movies-2016.csv,2016,0.3340538863311025,0.6659461136688974
299,Dark Shadows,245527149,79727149,165800000,movies-2012.csv,2012,0.3247182616045446,0.6752817383954554
300,Dolittle,245229574,77047065,168182509,movies-2020.csv,2020,0.31418341492531404,0.685816585074686
301,The Bravest,245179562,290217,244889345,movies-2019.csv,2019,0.0011836916488169597,0.9988163083511831
302,Pixels,244874809,78747585,166127224,movies-2015.csv,2015,0.3215830379677805,0.6784169620322195
303,Hercules,244819862,72688614,172131248,movies-2014.csv,2014,0.29690652304999665,0.7030934769500033
304,After Earth,243611982,60522097,183089885,movies-2013.csv,2013,0.24843645416422908,0.7515635458357709
305,Daddy's Home,242786137,150357137,92429000,movies-2015.csv,2015,0.6192986916711806,0.38070130832881943
306,RoboCop,242688965,58607007,184081958,movies-2014.csv,2014,0.24149020125410317,0.7585097987458969
307,Alien: Covenant,240891763,74262031,166629732,movies-2017.csv,2017,0.3082796608533269,0.6917203391466731
308,Sully,240797623,125070033,115727590,movies-2016.csv,2016,0.5193989518742052,0.48060104812579485
309,Assassin's Creed,240697856,54647948,186049908,movies-2016.csv,2016,0.2270396126835463,0.7729603873164537
310,Legend of Deification,240581901,214670,240367231,movies-2020.csv,2020,0.0008922948863056827,0.9991077051136943
311,Resident Evil: Retribution,240159255,42345531,197813724,movies-2012.csv,2012,0.17632271136084263,0.8236772886391573
312,Planes,239258712,90288712,148970000,movies-2013.csv,2013,0.37736854489127236,0.6226314551087276
313,Crazy Rich Asians,238532921,174532921,64000000,movies-2018.csv,2018,0.7316932198218459,0.2683067801781541
314,Silver Linings Playbook,236412453,132092958,104319495,movies-2012.csv,2012,0.5587394247797937,0.44126057522020634
315,Hidden Figures,235956898,169607287,66349611,movies-2016.csv,2016,0.7188062245164792,0.2811937754835207
316,Spy,235666219,110825712,124840507,movies-2015.csv,2015,0.47026558354551445,0.5297344164544856
317,American Reunion,234989584,57011521,177978063,movies-2012.csv,2012,0.24261297045404362,0.7573870295459564
318,Alvin and the Chipmunks: The Road Chip,234798636,85886987,148911649,movies-2015.csv,2015,0.3657899741802589,0.6342100258197412
319,The Imitation Game,233555708,91125683,142430025,movies-2014.csv,2014,0.39016679909188945,0.6098332009081106
320,The Girl with the Dragon Tattoo,232617430,102515793,130101637,movies-2011.csv,2011,0.44070555246010584,0.5592944475398941
321,Argo,232325503,136025503,96300000,movies-2012.csv,2012,0.5854953556261105,0.4145046443738895
322,Annabelle Comes Home,231252591,74152591,157100000,movies-2019.csv,2019,0.32065626023623667,0.6793437397637634
323,Ghostbusters,229147509,128350574,100796935,movies-2016.csv,2016,0.5601220565744837,0.43987794342551634
324,Goodbye Mr. Loser,228122928,1293626,226829302,movies-2015.csv,2015,0.005670740820931423,0.9943292591790686
325,Paddington 2,227978523,40891591,187086932,movies-2017.csv,2017,0.17936597913655225,0.8206340208634477
326,The Green Hornet,227817248,98780042,129037206,movies-2011.csv,2011,0.4335933423267408,0.5664066576732593
327,Youth,227091290,1891956,225199334,movies-2017.csv,2017,0.00833125744276674,0.9916687425572333
328,Baby Driver,226945087,107825862,119119225,movies-2017.csv,2017,0.47511873213628986,0.5248812678637101
329,Immortals,226904017,83504017,143400000,movies-2011.csv,2011,0.3680147143450528,0.6319852856549473
330,Hansel & Gretel: Witch Hunters,226349749,55703475,170646274,movies-2013.csv,2013,0.2460947062945495,0.7539052937054505
331,Valerian and the City of a Thousand Planets,225874228,41189488,184684740,movies-2017.csv,2017,0.18235585513545174,0.8176441448645483
332,Better Days,225820914,1921657,223899257,movies-2019.csv,2019,0.00850965026206563,0.9914903497379344
333,Ford v Ferrari,225508210,117624357,107883853,movies-2019.csv,2019,0.521596783549477,0.47840321645052303
334,Non-Stop,222809600,92168600,130641000,movies-2014.csv,2014,0.4136652998793589,0.5863347001206412
335,Geostorm,221600160,33700160,187900000,movies-2017.csv,2017,0.15207642449355632,0.8479235755064437
336,Inferno,220021259,34343574,185677685,movies-2016.csv,2016,0.15609207108482184,0.8439079289151782
337,Green Lantern,219851172,116601172,103250000,movies-2011.csv,2011,0.5303641137742036,0.46963588622579644
338,Captain Phillips,218791811,107100855,111690956,movies-2013.csv,2013,0.4895103455220269,0.5104896544779731
339,Jack Reacher,218340595,80070736,138269859,movies-2012.csv,2012,0.3667239983476275,0.6332760016523725
340,The Emoji Movie,217776646,86089513,131687133,movies-2017.csv,2017,0.39531104267259215,0.6046889573274078
341,Dracula Untold,217124280,56280355,160843925,movies-2014.csv,2014,0.2592080213230874,0.7407919786769126
342,Central Intelligence,216972543,127440871,89531672,movies-2016.csv,2016,0.5873594383783389,0.412640561621661
343,The Help,216639112,169708112,46931000,movies-2011.csv,2011,0.7833678343363962,0.21663216566360372
344,Little Women,216601214,108101214,108500000,movies-2019.csv,2019,0.4990794465260938,0.5009205534739062
345,Bad Teacher,216197492,100292856,115904636,movies-2011.csv,2011,0.46389463204318765,0.5361053679568124
346,Ted 2,215863606,81476385,134387221,movies-2015.csv,2015,0.37744382441197616,0.6225561755880239
347,Just Go with It,214945591,103028109,111917482,movies-2011.csv,2011,0.4793218066054679,0.5206781933945321
348,The Expendables 3,214657577,39322544,175335033,movies-2014.csv,2014,0.18318730952599918,0.8168126904740008
349,Creed II,214215889,115715889,98500000,movies-2018.csv,2018,0.5401835015142131,0.45981649848578693
350,Smallfoot,214040103,83240103,130800000,movies-2018.csv,2018,0.3888995652370808,0.6111004347629192
351,Into the Woods,212902372,128002372,84900000,movies-2014.csv,2014,0.6012256735213829,0.39877432647861716
352,Bridget Jones's Baby,211952420,24252420,187700000,movies-2016.csv,2016,0.11442388815376583,0.8855761118462342
353,Battle Los Angeles,211819354,83552429,128266925,movies-2011.csv,2011,0.3944513446113144,0.6055486553886856
354,Fury,211817906,85817906,126000000,movies-2014.csv,2014,0.4051494400100433,0.5948505599899566
355,Horrible Bosses,209838559,117538559,92300000,movies-2011.csv,2011,0.5601380392628411,0.4398619607371589
356,Tomorrowland,209035668,93436322,115599346,movies-2015.csv,2015,0.44698745861878464,0.5530125413812154
357,Me Before You,208314186,56245075,152069111,movies-2016.csv,2016,0.2700011750519957,0.7299988249480043
358,Safe House,208076205,126373434,81702771,movies-2012.csv,2012,0.6073420745058283,0.3926579254941717
359,Paranormal Activity 3,207039844,104028807,103011037,movies-2011.csv,2011,0.5024579085366776,0.4975420914633224
360,London Has Fallen,205754447,62524260,143230187,movies-2016.csv,2016,0.30387804935268303,0.696121950647317
361,Journey to the West,205637183,18058,205619125,movies-2013.csv,2013,8.781485788005567e-05,0.99991218514212
362,White House Down,205366737,73103784,132262953,movies-2013.csv,2013,0.35596701329485503,0.644032986705145
363,A Dog's Purpose,205035819,64508620,140527199,movies-2017.csv,2017,0.3146212223533489,0.6853787776466511
364,Everest,203427584,43482270,159945314,movies-2015.csv,2015,0.2137481512831613,0.7862518487168387
365,Arrival,203388186,100546139,102842047,movies-2016.csv,2016,0.49435584719753584,0.5056441528024641
366,Need for Speed,203277636,43577636,159700000,movies-2014.csv,2014,0.2143749644943726,0.7856250355056273
367,The Addams Family,203044905,100044905,103000000,movies-2019.csv,2019,0.49272305059809307,0.5072769494019069
368,Birds of Prey: And the Fantabulous Emancipation of One Harley Quinn,201858461,84158461,117700000,movies-2020.csv,2020,0.41691817416561006,0.5830818258343899
369,Straight Outta Compton,201634991,161197785,40437206,movies-2015.csv,2015,0.7994534291917617,0.20054657080823834
370,21 Jump Street,201585328,138447667,63137661,movies-2012.csv,2012,0.6867943633278708,0.31320563667212925
371,Percy Jackson: Sea of Monsters,199850315,68559554,131290761,movies-2013.csv,2013,0.34305452057956476,0.6569454794204352
372,Total Recall,198467168,58877969,139589199,movies-2012.csv,2012,0.296663521696445,0.703336478303555
373,The Island,198326350,670883,197655467,movies-2018.csv,2018,0.0033827224672868736,0.9966172775327131
374,The Impossible,198087212,19019882,179067330,movies-2012.csv,2012,0.09601771769093302,0.903982282309067
375,Lost in Thailand,197757387,57387,197700000,movies-2012.csv,2012,0.00029018890707733716,0.9997098110929227
376,Christopher Robin,197744377,99215042,98529335,movies-2018.csv,2018,0.5017338217409844,0.4982661782590157
377,Jack the Giant Slayer,197687603,65187603,132500000,movies-2013.csv,2013,0.3297505863329225,0.6702494136670776
378,Smurfs: The Lost Village,197183546,45020282,152163264,movies-2017.csv,2017,0.22831662637814618,0.7716833736218538
379,The Other Woman,196710396,83911193,112799203,movies-2014.csv,2014,0.4265722336301941,0.5734277663698059
380,The Vow,196114570,125014030,71100540,movies-2012.csv,2012,0.6374540657535032,0.36254593424649684
381,The Shape of Water,195333312,63859435,131473877,movies-2017.csv,2017,0.3269254708587545,0.6730745291412455
382,The BFG,195243411,55483770,139759641,movies-2016.csv,2016,0.28417742609506036,0.7158225739049396
383,Rocketman,195179299,96368160,98811139,movies-2019.csv,2019,0.4937417056713581,0.5062582943286419
384,The Intern,194564672,75764672,118800000,movies-2015.csv,2015,0.38940610965591943,0.6105938903440805
385,Gnomeo & Juliet,193967670,99967670,94000000,movies-2011.csv,2011,0.5153831563785862,0.48461684362141383
386,Downton Abbey,193820755,96854135,96966620,movies-2019.csv,2019,0.49970982209825776,0.5002901779017422
387,The Monkey King 2,193678298,709982,192968316,movies-2016.csv,2016,0.003665779838689,0.996334220161311
388,Weathering with You,193245681,7798743,185446938,movies-2019.csv,2019,0.0403566225110097,0.9596433774889903
389,The Equalizer,192330738,101530738,90800000,movies-2014.csv,2014,0.527896575741315,0.47210342425868507
390,The LEGO Movie 2: The Second Part,192306508,105806508,86500000,movies-2019.csv,2019,0.5501972299346208,0.44980277006537916
391,The Equalizer 2,190400157,102084362,88315795,movies-2018.csv,2018,0.5361569213411941,0.4638430786588059
392,The White Storm 2: Drug Lords,189396380,609461,188786919,movies-2019.csv,2019,0.003217912612690908,0.9967820873873091
393,Breakup Buddies,189017596,777896,188239700,movies-2014.csv,2014,0.004115468699538428,0.9958845313004616
394,The Secret Life of Walter Mitty,188133322,58236838,129896484,movies-2013.csv,2013,0.30955089391341317,0.6904491060865868
395,12 Years a Slave,187733202,56671993,131061209,movies-2013.csv,2013,0.30187517389704993,0.6981248261029501
396,Mr. Popper's Penguins,187361754,68224452,119137302,movies-2011.csv,2011,0.3641322230576471,0.635867776942353
397,Hugo,185770160,73864507,111905653,movies-2011.csv,2011,0.39761233451055866,0.6023876654894413
398,The Lion King 2011 3D Release,185542001,94242001,91300000,movies-2011.csv,2011,0.5079281267425805,0.49207187325741947
399,Pitch Perfect 3,185400345,104897530,80502815,movies-2017.csv,2017,0.5657892923554161,0.4342107076445839
400,Hop,183953723,108085305,75868418,movies-2011.csv,2011,0.5875679123928359,0.4124320876071641
401,Bad Moms,183936074,113257297,70678777,movies-2016.csv,2016,0.615742711785835,0.3842572882141651
402,Jupiter Ascending,183887723,47387723,136500000,movies-2015.csv,2015,0.25769922117095334,0.7423007788290467
403,Storks,183388953,72679278,110709675,movies-2016.csv,2016,0.3963121922616571,0.6036878077383429
404,Mirror Mirror,183018522,64935167,118083355,movies-2012.csv,2012,0.3548010676209045,0.6451989323790955
405,Daddy's Home 2,180613180,104029443,76583737,movies-2017.csv,2017,0.5759792447040687,0.42402075529593136
406,Hacksaw Ridge,180450918,67209615,113241303,movies-2016.csv,2016,0.3724537161955585,0.6275462838044414
407,The Post,179769457,81903458,97865999,movies-2017.csv,2017,0.4556027445752367,0.5443972554247632
408,The Dictator,179379533,59650222,119729311,movies-2012.csv,2012,0.3325363880839181,0.6674636119160818
409,Allegiant,179246868,66184051,113062817,movies-2016.csv,2016,0.36923407219589466,0.6307659278041053
410,Abominable,179057149,60716390,118340759,movies-2019.csv,2019,0.3390894490339506,0.6609105509660493
411,Baywatch,177856751,58060186,119796565,movies-2017.csv,2017,0.32644353207599075,0.6735564679240093
412,War Horse,177584879,79884879,97700000,movies-2011.csv,2011,0.44984054639021376,0.5501594536097862
413,Lee Daniels' The Butler,177313795,116632095,60681700,movies-2013.csv,2013,0.6577722562421046,0.34222774375789544
414,The Descendants,177243185,82584160,94659025,movies-2011.csv,2011,0.4659370119082435,0.5340629880917566
415,The Hitman's Bodyguard,176586701,75468583,101118118,movies-2017.csv,2017,0.4273741033306919,0.5726258966693081
416,Looper,176506819,66486205,110020614,movies-2012.csv,2012,0.37667782682095696,0.623322173179043
417,Ip Man 4: The Finale,176345966,3956031,172389935,movies-2019.csv,2019,0.02243335126815433,0.9775666487318456
418,Cowboys & Aliens,174822325,100240551,74581774,movies-2011.csv,2011,0.5733852984737504,0.4266147015262496
419,The Mule,174804407,103804407,71000000,movies-2018.csv,2018,0.5938317504775494,0.40616824952245056
420,Identity Thief,173965010,134506920,39458090,movies-2013.csv,2013,0.7731837568945618,0.22681624310543827
421,The Nutcracker and the Four Realms,173961069,54858851,119102218,movies-2018.csv,2018,0.3153513100106323,0.6846486899893677
422,In Time,173930596,37520095,136410501,movies-2011.csv,2011,0.215718774401256,0.784281225598744
423,Operation Mekong,173839072,800012,173039060,movies-2016.csv,2016,0.004602026407504062,0.9953979735924959
424,Creed,173567581,109767581,63800000,movies-2015.csv,2015,0.6324198353608442,0.3675801646391557
425,Gemini Man,173469516,48546770,124922746,movies-2019.csv,2019,0.27985764369112553,0.7201423563088745
426,The Girl on the Train,173185859,75395035,97790824,movies-2016.csv,2016,0.435341750390833,0.564658249609167
427,The Grand Budapest Hotel,172936941,59301324,113635617,movies-2014.csv,2014,0.342907210322403,0.657092789677597
428,Spies in Disguise,171616764,66757013,104859751,movies-2019.csv,2019,0.3889888810629246,0.6110111189370754
429,John Wick: Chapter 2,171539887,92029184,79510703,movies-2017.csv,2017,0.5364885427492441,0.46351145725075593
430,Anchorman 2: The Legend Continues,171464676,125168368,46296308,movies-2013.csv,2013,0.7299950690718361,0.2700049309281639
431,Olympus Has Fallen,170270201,98925640,71344561,movies-2013.csv,2013,0.5809920903305916,0.4190079096694083
432,Zookeeper,169852759,80360843,89491916,movies-2011.csv,2011,0.47312062207950356,0.5268793779204964
433,Dumb and Dumber To,169837010,86208010,83629000,movies-2014.csv,2014,0.5075926030492411,0.49240739695075886
434,Ghost in the Shell,169801921,40563557,129238364,movies-2017.csv,2017,0.23888750351652382,0.7611124964834762
435,Insidious: The Last Key,167885588,67745330,100140258,movies-2018.csv,2018,0.40352081919026905,0.596479180809731
436,Fantastic Four,167882881,56117548,111765333,movies-2015.csv,2015,0.3342660530110869,0.6657339469889131
437,Magic Mike,167739368,113721571,54017797,movies-2012.csv,2012,0.6779658964733908,0.3220341035266092
438,Bridge of Spies,165478348,72313754,93164594,movies-2015.csv,2015,0.4369982833041094,0.5630017166958906
439,The Muppets,165184237,88631237,76553000,movies-2011.csv,2011,0.5365598958452676,0.4634401041547324
440,The Huntsman: Winter's War,164989338,48390190,116599148,movies-2016.csv,2016,0.2932928308373478,0.7067071691626522
441,The Magnificent Seven,162360636,93432655,68927981,movies-2016.csv,2016,0.5754637164638847,0.4245362835361152
442,Jack Reacher: Never Go Back,162146076,58697076,103449000,movies-2016.csv,2016,0.36200121179620776,0.6379987882037922
443,Insidious: Chapter 2,161919318,83586447,78332871,movies-2013.csv,2013,0.5162228203060983,0.4837771796939016
444,Limitless,161849455,79249455,82600000,movies-2011.csv,2011,0.489649192825518,0.510350807174482
445,Flight,161772375,93772375,68000000,movies-2012.csv,2012,0.5796562917494411,0.42034370825055883
446,Into the Storm,161502194,47602194,113900000,movies-2014.csv,2014,0.29474642307336085,0.7052535769266391
447,Unbroken,161459297,115637895,45821402,movies-2014.csv,2014,0.7162046233856698,0.28379537661433024
448,The Predator,160542134,51024708,109517426,movies-2018.csv,2018,0.3178275181018835,0.6821724818981165
449,"Three Billboards Outside Ebbing, Missouri",160192031,54513740,105678291,movies-2017.csv,2017,0.3403024461310438,0.6596975538689562
450,Underworld: Awakening,160112671,62321039,97791632,movies-2012.csv,2012,0.3892323987275186,0.6107676012724814
451,Johnny English Reborn,160078586,8305970,151772616,movies-2011.csv,2011,0.051886827636021225,0.9481131723639787
452,Happy Feet Two,159196259,64006466,95189793,movies-2011.csv,2011,0.4020601137367179,0.5979398862632821
453,Johnny English Strikes Again,158970776,4412170,154558606,movies-2018.csv,2018,0.02775459811556811,0.9722454018844319
454,Focus,158762963,53862963,104900000,movies-2015.csv,2015,0.3392665517334795,0.6607334482665205
455,Goosebumps,158260952,80080379,78180573,movies-2015.csv,2015,0.5060021312142745,0.4939978687857255
456,Final Destination 5,157887643,42587643,115300000,movies-2011.csv,2011,0.26973385751283907,0.7302661424871609
457,Don't Breathe,157830487,89217875,68612612,movies-2016.csv,2016,0.565276561555563,0.4347234384444369
458,Hustlers,157563598,104963598,52600000,movies-2019.csv,2019,0.6661665469203109,0.33383345307968915
459,Ip Man 3,156954938,2679437,154275501,movies-2015.csv,2015,0.01707137751855886,0.9829286224814411
460,The Climbers,156892866,487157,156405709,movies-2019.csv,2019,0.0031050296448788183,0.9968949703551212
461,This Means War,156491279,54760791,101730488,movies-2012.csv,2012,0.3499287075288074,0.6500712924711926
462,The Hateful Eight,155760117,54117416,101642701,movies-2015.csv,2015,0.3474407765114866,0.6525592234885135
463,Escape Room,155712077,57005601,98706476,movies-2019.csv,2019,0.36609620845273294,0.6339037915472671
464,The Monuments Men,155641650,78031620,77610030,movies-2014.csv,2014,0.5013543611237737,0.49864563887622626
465,The Accountant,155160045,86260045,68900000,movies-2016.csv,2016,0.5559423819450426,0.44405761805495736
466,Lone Survivor,154802912,125095601,29707311,movies-2013.csv,2013,0.8080959161801814,0.19190408381981858
467,Ride Along,154468902,134938200,19530702,movies-2014.csv,2014,0.8735622397315933,0.12643776026840664
468,Midnight in Paris,153959590,56817045,97142545,movies-2011.csv,2011,0.36903868735945583,0.6309613126405442
469,Yesterday,153178301,73286650,79891651,movies-2019.csv,2019,0.47844015452293076,0.5215598454770692
470,Tower Heist,152930623,78046570,74884053,movies-2011.csv,2011,0.5103397113604906,0.48966028863950944
471,Duckweed,152894264,471575,152422689,movies-2017.csv,2017,0.0030843210704098096,0.9969156789295902
472,Jackass Presents: Bad Grandpa,151826547,102003019,49823528,movies-2013.csv,2013,0.6718391547164674,0.3281608452835327
473,47 Ronin,151783839,38362475,113421364,movies-2013.csv,2013,0.25274413437388416,0.7472558656261158
474,Red Sparrow,151572634,46874505,104698129,movies-2018.csv,2018,0.30925440670246584,0.6907455932975342
475,Darkest Hour,150847207,56468410,94378797,movies-2017.csv,2017,0.37434176689794463,0.6256582331020554
476,Gods of Egypt,150680864,31153464,119527400,movies-2015.csv,2015,0.20675129656808977,0.7932487034319102
477,I Am Number Four,149878437,55100437,94778000,movies-2011.csv,2011,0.36763418476268206,0.6323658152373179
478,Jack and Jill,149673788,74158157,75515631,movies-2011.csv,2011,0.49546522467915355,0.5045347753208465
479,Friends with Benefits,149542245,55802754,93739491,movies-2011.csv,2011,0.37315712359407205,0.626842876405928
480,No Strings Attached,149228077,70662220,78565857,movies-2011.csv,2011,0.473518264260686,0.526481735739314
481,Lights Out,148868835,67268835,81600000,movies-2016.csv,2016,0.4518664702387172,0.5481335297612828
482,King Arthur: Legend of the Sword,148675066,39175066,109500000,movies-2017.csv,2017,0.2634945257061463,0.7365054742938537
483,RED 2,148075565,53262560,94813005,movies-2013.csv,2013,0.35969850933879605,0.640301490661204
484,The Angry Birds Movie 2,147792047,41667116,106124931,movies-2019.csv,2019,0.2819307049722371,0.7180692950277628
485,Arthur Christmas,147419472,46462469,100957003,movies-2011.csv,2011,0.31517185870805453,0.6848281412919455
486,Source Code,147332697,54712227,92620470,movies-2011.csv,2011,0.3713515608826464,0.6286484391173536
487,Planes: Fire & Rescue,146965787,59165787,87800000,movies-2014.csv,2014,0.402582044486313,0.597417955513687
488,The Last Witch Hunter,146936910,27367660,119569250,movies-2015.csv,2015,0.18625449521158435,0.8137455047884157
489,Angel Has Fallen,146661977,69030436,77631541,movies-2019.csv,2019,0.470677113537069,0.529322886462931
490,Mama,146428180,71628180,74800000,movies-2013.csv,2013,0.4891693661698179,0.5108306338301821
491,The Foreigner,145374099,34393507,110980592,movies-2017.csv,2017,0.23658620921186244,0.7634137907881375
492,"Crazy, Stupid, Love.",145051197,84351197,60700000,movies-2011.csv,2011,0.5815270659227997,0.4184729340772003
493,Pete's Dragon,143695338,76233151,67462187,movies-2016.csv,2016,0.5305193060612725,0.4694806939387275
494,More Than Blue,142958164,722669,142235495,movies-2018.csv,2018,0.005055108290282743,0.9949448917097172
495,Paranormal Activity 4,142802657,53885000,88917657,movies-2012.csv,2012,0.3773389174404507,0.6226610825595493
496,Power Rangers,142337240,85364450,56972790,movies-2017.csv,2017,0.5997337731151735,0.4002662268848265
497,New Year's Eve,142044638,54544638,87500000,movies-2011.csv,2011,0.3839964589159641,0.6160035410840359
498,The Taking of Tiger Mountain,141654055,228984,141425071,movies-2014.csv,2014,0.0016165015537324364,0.9983834984462676
499,Onward,141517253,61555145,79962108,movies-2020.csv,2020,0.43496565750891164,0.5650343424910883
500,Trainwreck,140795793,110212700,30583093,movies-2015.csv,2015,0.7827840424180856,0.2172159575819144
501,Sausage Party,140705322,97685686,43019636,movies-2016.csv,2016,0.6942572221966131,0.3057427778033869
502,Girls Trip,140552359,115171585,25380774,movies-2017.csv,2017,0.8194212165446473,0.18057878345535275
503,Step Up Revolution,140470746,35074677,105396069,movies-2012.csv,2012,0.24969381881121355,0.7503061811887864
504,Lion,140312928,51738905,88574023,movies-2016.csv,2016,0.3687394008341127,0.6312605991658873
505,Mr. Six,139191345,1415450,137775895,movies-2015.csv,2015,0.010169094924688026,0.989830905075312
506,The Admiral: Roaring Currents,138342258,2589811,135752447,movies-2014.csv,2014,0.018720317547513212,0.9812796824524868
507,Let's Be Cops,138224951,82390774,55834177,movies-2014.csv,2014,0.5960629640592168,0.40393703594078323
508,Escape Plan,137328301,25135965,112192336,movies-2013.csv,2013,0.18303557836923942,0.8169644216307606
509,The First Purge,137056262,69488745,67567517,movies-2018.csv,2018,0.5070089026650968,0.49299109733490326
510,Annie,136853506,85911262,50942244,movies-2014.csv,2014,0.6277607677804031,0.3722392322195969
511,The Best Exotic Marigold Hotel,136836156,46412041,90424115,movies-2012.csv,2012,0.3391796609662142,0.6608203390337858
512,How Long Will I Love U,136796719,746933,136049786,movies-2018.csv,2018,0.005460167505918033,0.994539832494082
513,Contagion,136515867,75658097,60857770,movies-2011.csv,2011,0.5542073508568788,0.4457926491431212
514,The Wind Rises,136454220,5209580,131244640,movies-2012.csv,2012,0.03817822563494189,0.9618217743650581
515,Unknown,135710029,63686397,72023632,movies-2011.csv,2011,0.4692829076029451,0.5307170923970549
516,Jack Ryan: Shadow Recruit,135503748,50577412,84926336,movies-2014.csv,2014,0.3732547087922616,0.6267452912077384
517,American Made,134866593,51342000,83524593,movies-2017.csv,2017,0.3806873063072039,0.6193126936927961
518,Last Vegas,134402450,63914167,70488283,movies-2012.csv,2012,0.4755431690419334,0.5244568309580666
519,Point Break,133718711,28782481,104936230,movies-2015.csv,2015,0.21524647362178057,0.7847535263782194
520,The Big Short,133440870,70259870,63181000,movies-2015.csv,2015,0.5265243699325401,0.47347563006745985
521,The Artist,133432856,44671682,88761174,movies-2011.csv,2011,0.33478772274798646,0.6652122772520136
522,Zero Dark Thirty,132820716,95720716,37100000,movies-2012.csv,2012,0.7206761029657452,0.2793238970342548
523,A Wrinkle in Time,132675864,100478608,32197256,movies-2018.csv,2018,0.7573239394921144,0.2426760605078856
524,Ghost Rider: Spirit of Vengeance,132563930,51774002,80789928,movies-2012.csv,2012,0.39055874399619867,0.6094412560038014
525,The Three Musketeers,132274484,20374484,111900000,movies-2011.csv,2011,0.1540318539439549,0.8459681460560451
526,2 Guns,131940411,75612460,56327951,movies-2013.csv,2013,0.5730803733815867,0.4269196266184134
527,The House with a Clock in Its Walls,131457147,68549695,62907452,movies-2018.csv,2018,0.521460388912898,0.478539611087102
528,The Invisible Man,130560433,64914050,65646383,movies-2020.csv,2020,0.4971954252020595,0.5028045747979405
529,A Bad Moms Christmas,130560428,72110659,58449769,movies-2017.csv,2017,0.5523163496369665,0.4476836503630334
530,Cloud Atlas,130482868,27108272,103374596,movies-2012.csv,2012,0.2077534960375028,0.7922465039624972
531,The Woman in Black,128955898,54333290,74622608,movies-2012.csv,2012,0.4213323379749564,0.5786676620250436
532,Pan,128388320,35088320,93300000,movies-2015.csv,2015,0.2732983810365304,0.7267016189634695
533,Blended,127994610,46294610,81700000,movies-2014.csv,2014,0.36169187124364066,0.6383081287563593
534,Ad Astra,127461872,50188370,77273502,movies-2019.csv,2019,0.393752023350167,0.606247976649833
535,Midway,126696475,56846802,69849673,movies-2019.csv,2019,0.4486849535474448,0.5513150464525552
536,Chronicle,126636097,64575175,62060922,movies-2012.csv,2012,0.5099270786906833,0.49007292130931673
537,Walking with Dinosaurs 3D,126546518,36076121,90470397,movies-2012.csv,2012,0.2850818937586256,0.7149181062413744
538,Sex Tape,126069509,38543473,87526036,movies-2014.csv,2014,0.30573191968249835,0.6942680803175016
539,This Is the End,126041322,101470202,24571120,movies-2013.csv,2013,0.8050550437736602,0.1949449562263398
540,The Upside,125852517,108252517,17600000,movies-2019.csv,2019,0.860153770305603,0.13984622969439697
541,Detective Chinatown,125842935,474252,125368683,movies-2015.csv,2015,0.003768602504383738,0.9962313974956163
542,Wolf Totem,125837070,210591,125626479,movies-2015.csv,2015,0.0016735211651065938,0.9983264788348934
543,Mechanic: Resurrection,125729635,21218403,104511232,movies-2016.csv,2016,0.1687621458536804,0.8312378541463196
544,Ender's Game,125544024,61737191,63806833,movies-2013.csv,2013,0.49175730578780874,0.5082426942121913
545,Happy Death Day,125479266,55683845,69795421,movies-2017.csv,2017,0.44376929173302626,0.5562307082669737
546,Captain Underpants: The First Epic Movie,125427681,73921000,51506681,movies-2017.csv,2017,0.5893515642691345,0.4106484357308655
547,Ride Along 2,124605297,91221830,33383467,movies-2015.csv,2015,0.7320862932496361,0.2679137067503639
548,The Theory of Everything,123726688,35893537,87833151,movies-2014.csv,2014,0.2901034334645731,0.7098965665354269
549,The Curse of la Llorona,123133739,54733739,68400000,movies-2019.csv,2019,0.4445064321485438,0.5554935678514562
550,The Lego Ninjago Movie,123081555,59281555,63800000,movies-2017.csv,2017,0.4816445079849698,0.5183554920150302
551,The Pirates! Band of Misfits,123054041,31051126,92002915,movies-2012.csv,2012,0.25233731251458863,0.7476626874854114
552,Looking Up,122994583,84267,122910316,movies-2019.csv,2019,0.0006851277344466463,0.9993148722655534
553,Zombieland: Double Tap,122810399,73123082,49687317,movies-2019.csv,2019,0.5954144160056023,0.40458558399439776
554,Dragon Blade,122593849,74068,122519781,movies-2015.csv,2015,0.0006041738684621934,0.9993958261315378
555,Prisoners,122126687,61002302,61124385,movies-2013.csv,2013,0.4995001788593512,0.5004998211406488
556,Secret Superstar,122026260,0,122026260,movies-2017.csv,2017,0.0,1.0
557,Deepwater Horizon,121790373,61433527,60356846,movies-2016.csv,2016,0.5044202221139433,0.4955797778860567
558,Last Christmas,121550750,35150750,86400000,movies-2019.csv,2019,0.2891857927655732,0.7108142072344268
559,The Nut Job,120885527,64251541,56633986,movies-2014.csv,2014,0.531507307735855,0.4684926922641451
560,Instant Family,120556201,67363237,53192964,movies-2018.csv,2018,0.5587704028596588,0.4412295971403412
561,We Bought a Zoo,120081841,75624550,44457291,movies-2011.csv,2011,0.629775071486454,0.37022492851354605
562,The Commuter,119942387,36343858,83598529,movies-2017.csv,2017,0.3030109614210029,0.6969890385789971
563,Extreme Job,119932733,1565885,118366848,movies-2019.csv,2019,0.013056360518358236,0.9869436394816418
564,Parental Guidance,119772232,77267296,42504936,movies-2012.csv,2012,0.6451186114658028,0.35488138853419715
565,Dora and the Lost City of Gold,119682635,60477943,59204692,movies-2019.csv,2019,0.505319280445321,0.4946807195546789
566,Wonder Park,119559110,45216793,74342317,movies-2019.csv,2019,0.37819613244026323,0.6218038675597368
567,Allied,119520023,40098064,79421959,movies-2016.csv,2016,0.33549243878575896,0.664507561214241
568,I Belonged to You,119107580,744541,118363039,movies-2016.csv,2016,0.006250995948368693,0.9937490040516314
569,The Shallows,119100758,55124043,63976715,movies-2016.csv,2016,0.46283536667331704,0.537164633326683
570,The Purge: Election Year,118587880,79213375,39374505,movies-2016.csv,2016,0.6679719293405025,0.3320280706594974
571,Jurassic Park 2013 Re-release,118192315,45385935,72806380,movies-2013.csv,2013,0.38400072796611184,0.6159992720338882
572,A Cool Fish,118153135,551876,117601259,movies-2018.csv,2018,0.004670853634141828,0.9953291463658581
573,Why Him?,118102725,60323786,57778939,movies-2016.csv,2016,0.5107738707976467,0.4892261292023533
574,P Storm,117991727,326711,117665016,movies-2019.csv,2019,0.0027689314183866466,0.9972310685816134
575,Saving Mr. Banks,117867984,83301580,34566404,movies-2013.csv,2013,0.7067362753909493,0.29326372460905076
576,Pompeii,117831631,23219748,94611883,movies-2014.csv,2014,0.19705869979852864,0.8029413002014714
577,Magic Mike XXL,117813057,66013057,51800000,movies-2015.csv,2015,0.5603203811271954,0.43967961887280455
578,Game Night,117679066,69179066,48500000,movies-2018.csv,2018,0.5878621266419637,0.41213787335803637
579,Water for Elephants,117094902,58709717,58385185,movies-2011.csv,2011,0.5013857648559286,0.49861423514407144
580,Warm Bodies,116980662,66380662,50600000,movies-2013.csv,2013,0.5674498747493838,0.4325501252506162
581,Abraham Lincoln: Vampire Hunter,116471580,37519139,78952441,movies-2012.csv,2012,0.32213127872052566,0.6778687212794744
582,Personal Tailor,116126458,375892,115750566,movies-2013.csv,2013,0.0032369195312923434,0.9967630804687077
583,The Iron Lady,115890699,30017992,85872707,movies-2011.csv,2011,0.25901985456140875,0.7409801454385913
584,Dragon Ball Super: Broly,115560610,30712119,84848491,movies-2018.csv,2018,0.2657663281632037,0.7342336718367963
585,Pitch Perfect,115350426,65001093,50349333,movies-2012.csv,2012,0.5635097784554346,0.4364902215445654
586,The Gentlemen,115171795,36471795,78700000,movies-2019.csv,2019,0.31667297535824634,0.6833270246417537
587,The Monkey King 3,115084576,187074,114897502,movies-2018.csv,2018,0.0016255349457081026,0.998374465054292
588,So Young,114926694,11186,114915508,movies-2013.csv,2013,9.733160861653256e-05,0.9999026683913834
589,Finding Mr Right 2,114679097,0,114679097,movies-2016.csv,2016,0.0,1.0
590,Office Christmas Party,114501299,54767494,59733805,movies-2016.csv,2016,0.47831329843690246,0.5216867015630976
591,Hope Springs,114281051,63536011,50745040,movies-2012.csv,2012,0.5559627816163504,0.4440372183836496
592,Seventh Son,114178613,17223265,96955348,movies-2014.csv,2014,0.15084493100297164,0.8491550689970284
593,The Dark Tower,113231078,50701325,62529753,movies-2017.csv,2017,0.44776863291895885,0.5522313670810411
594,Pet Sematary,113118226,54724696,58393530,movies-2019.csv,2019,0.4837831880425706,0.5162168119574294
595,Insidious: Chapter 3,112983889,52218558,60765331,movies-2015.csv,2015,0.46217702773534375,0.5378229722646563
596,Deliver Us from Evil,112781920,30577122,82204798,movies-2014.csv,2014,0.2711172322655972,0.7288827677344029
597,How to Be Single,112343513,46843513,65500000,movies-2016.csv,2016,0.4169667811616324,0.5830332188383677
598,The Purge: Anarchy,111928365,71962800,39965565,movies-2014.csv,2014,0.6429362208587609,0.35706377914123916
599,Get Hard,111711453,90411453,21300000,movies-2015.csv,2015,0.809330203591569,0.19066979640843093
600,Good Boys,111037232,83140306,27896926,movies-2019.csv,2019,0.748760613917321,0.251239386082679
601,Free Birds,110387072,55750480,54636592,movies-2013.csv,2013,0.5050453734292364,0.49495462657076367
602,10 Cloverfield Lane,110216998,72082998,38134000,movies-2016.csv,2016,0.6540098107190326,0.34599018928096736
603,Moneyball,110206216,75605492,34600724,movies-2011.csv,2011,0.6860365480654921,0.3139634519345079
604,Buddies in India,110155128,293194,109861934,movies-2017.csv,2017,0.002661646401064506,0.9973383535989355
605,The 5th Wave,109906372,34916787,74989585,movies-2015.csv,2015,0.3176957474312772,0.6823042525687227
606,Along With the Gods: The Two Worlds,109383972,1908823,107475149,movies-2017.csv,2017,0.017450664526974757,0.9825493354730253
607,The Boxtrolls,108255770,50837305,57418465,movies-2014.csv,2014,0.4696036525351027,0.5303963474648973
608,Neighbors 2: Sorority Rising,108007109,55455765,52551344,movies-2016.csv,2016,0.5134455084803723,0.48655449151962765
609,Horrible Bosses 2,107645357,54445357,53200000,movies-2014.csv,2014,0.5057845365313806,0.49421546346861944
610,The Call of the Wild,107604626,62342368,45262258,movies-2020.csv,2020,0.579365128781731,0.420634871218269
611,Paul Blart: Mall Cop 2,107588225,71038190,36550035,movies-2015.csv,2015,0.6602784830774929,0.33972151692250707
612,Vacation,107228221,58884188,48344033,movies-2015.csv,2015,0.5491482321617552,0.45085176783824477
613,ParaNorman,107139399,56003051,51136348,movies-2012.csv,2012,0.5227120137196215,0.4772879862803785
614,The Man from U.N.C.L.E.,107045109,45445109,61600000,movies-2015.csv,2015,0.42454166682197503,0.575458333178025
615,The Breakup Guru,106980263,208959,106771304,movies-2014.csv,2014,0.00195324814260365,0.9980467518573963
616,Shaun the Sheep Movie,106209378,19375982,86833396,movies-2015.csv,2015,0.18243193176406702,0.817568068235933
617,First Man,105697415,44936545,60760870,movies-2018.csv,2018,0.4251432733714443,0.5748567266285557
618,Gangster Squad,105200903,46000903,59200000,movies-2013.csv,2013,0.4372671877160598,0.5627328122839402
619,Sisters,105011053,87044645,17966408,movies-2015.csv,2015,0.8289093625220576,0.17109063747794245
620,The Campaign,104907746,86907746,18000000,movies-2012.csv,2012,0.8284206773444546,0.17157932265554537
621,Scary Stories to Tell in the Dark,104545505,68947075,35598430,movies-2019.csv,2019,0.6594934425922951,0.3405065574077049
622,Book Club,104438188,68566296,35871892,movies-2018.csv,2018,0.6565251400187065,0.34347485998129346
623,Ouija,103590271,50856010,52734261,movies-2014.csv,2014,0.49093423068658637,0.5090657693134136
624,Birdman or (The Unexpected Virtue of Ignorance),103215094,42340598,60874496,movies-2014.csv,2014,0.41021711417518064,0.5897828858248194
625,Cold War II,103197501,560824,102636677,movies-2016.csv,2016,0.00543447268165922,0.9945655273183408
626,Night School,103105878,77339130,25766748,movies-2018.csv,2018,0.75009428657404,0.24990571342596005
627,Transcendence,103039258,23022309,80016949,movies-2014.csv,2014,0.22343240282262125,0.7765675971773788
628,Jigsaw,102952888,38052832,64900056,movies-2017.csv,2017,0.3696140316141496,0.6303859683858505
629,Chappie,102811889,31569268,71242621,movies-2015.csv,2015,0.3070585348354022,0.6929414651645979
630,Star Wars: Episode I - The Phantom Menace 2012 3D Release,102739593,43456382,59283211,movies-2012.csv,2012,0.4229759991359903,0.5770240008640096
631,Project X,102731865,54731865,48000000,movies-2012.csv,2012,0.5327642499238187,0.46723575007618134
632,Railroad Tigers,102205175,218044,101987131,movies-2016.csv,2016,0.002133394908819441,0.9978666050911805
633,Heaven Is for Real,101888019,91443253,10444766,movies-2014.csv,2014,0.8974877900020806,0.10251220999791938
634,The Devil Inside,101758490,53261944,48496546,movies-2012.csv,2012,0.5234152354265477,0.4765847645734523
635,Joy,101134059,56451232,44682827,movies-2015.csv,2015,0.5581822044737669,0.4418177955262332
636,"Alexander and the Terrible, Horrible, No Good, Very Bad Day",100654149,66954149,33700000,movies-2014.csv,2014,0.665190155251325,0.334809844748675
637,Life,100541806,30234022,70307784,movies-2017.csv,2017,0.30071095003008,0.69928904996992
638,Instructions Not Included,100486616,44467206,56019410,movies-2013.csv,2013,0.44251869323572407,0.557481306764276
639,Tammy,100375432,84525432,15850000,movies-2014.csv,2014,0.8420928340313395,0.15790716596866053
640,PK,100370104,10616104,89754000,movies-2014.csv,2014,0.10576958254422054,0.8942304174557795
641,Philomena,100129872,37709979,62419893,movies-2013.csv,2013,0.376610678180034,0.623389321819966
642,Atomic Blonde,100014025,51687870,48326155,movies-2017.csv,2017,0.5168062179279356,0.48319378207206437
643,The Book of Life,99783556,50151543,49632013,movies-2014.csv,2014,0.5026032846534353,0.4973967153465647
644,Black Mass,99775678,62575678,37200000,movies-2015.csv,2015,0.6271636460340565,0.3728363539659435
645,Insidious,99557032,54009150,45547882,movies-2011.csv,2011,0.5424945773795266,0.45750542262047345
646,Line Walker 2: Invisible Spy,99482027,296751,99185276,movies-2019.csv,2019,0.002982960932229497,0.9970170390677705
647,The Lucky One,99357138,60457138,38900000,movies-2012.csv,2012,0.6084830865397914,0.39151691346020856
648,Blue Jasmine,99104804,33405481,65699323,movies-2013.csv,2013,0.3370722674553698,0.6629277325446302
649,Ode To My Father,99085291,2300121,96785170,movies-2014.csv,2014,0.023213546398122804,0.9767864536018772
650,Justin Bieber: Never Say Never,99036827,73013910,26022917,movies-2011.csv,2011,0.7372399965923787,0.2627600034076213
651,Young Detective Dee: Rise of the Sea Dragon,98774891,87783,98687108,movies-2013.csv,2013,0.0008887177612780155,0.999111282238722
652,Spotlight,98690254,45055776,53634478,movies-2015.csv,2015,0.45653723821604514,0.5434627617839549
653,Devil and Angel,98599942,131058,98468884,movies-2015.csv,2015,0.0013291894228497619,0.9986708105771502
654,The Visit,98450062,65206105,33243957,movies-2015.csv,2015,0.6623267032579421,0.3376732967420579
655,Riddick,98337295,42025135,56312160,movies-2013.csv,2013,0.4273570368190421,0.572642963180958
656,Alpha,98203196,35857181,62346015,movies-2018.csv,2018,0.36513252582940375,0.6348674741705962
657,Paul,97984015,37412945,60571070,movies-2011.csv,2011,0.3818270255612612,0.6181729744387388
658,Along With the Gods: The Last 49 Days,97962238,1200246,96761992,movies-2018.csv,2018,0.012252129233715547,0.9877478707662845
659,A Simple Favor,97644617,53548586,44096031,movies-2018.csv,2018,0.5484028474401206,0.4515971525598795
660,Safe Haven,97594140,71349120,26245020,movies-2013.csv,2013,0.7310799603336839,0.26892003966631606
661,The Little Prince,97571250,1339152,96232098,movies-2015.csv,2015,0.013724862600407395,0.9862751373995926
662,Evil Dead,97542952,54239856,43303096,movies-2013.csv,2013,0.5560612518677925,0.44393874813220746
663,42,97470701,95020213,2450488,movies-2013.csv,2013,0.9748592348792074,0.025140765120792555
664,Scream 4,97138686,38180928,58957758,movies-2011.csv,2011,0.39305584183010256,0.6069441581698974
665,The Shack,96942115,57386418,39555697,movies-2017.csv,2017,0.5919658138261168,0.40803418617388326
666,The Rite,96560591,33047633,63512958,movies-2011.csv,2011,0.34224762563849676,0.6577523743615032
667,Contraband,96262212,66528000,29734212,movies-2012.csv,2012,0.6911123131057907,0.3088876868942093
668,Assassination,96119773,1904682,94215091,movies-2015.csv,2015,0.019815714712518098,0.9801842852874819
669,Think Like a Man,96070507,91547205,4523302,movies-2012.csv,2012,0.9529168509540602,0.04708314904593977
670,Dolphin Tale,95932565,72286779,23645786,movies-2011.csv,2011,0.7535165874069978,0.2464834125930022
671,The Favourite,95918706,34366783,61551923,movies-2018.csv,2018,0.35829072798375744,0.6417092720162426
672,Some Like It Hot,95721320,100026,95621294,movies-2016.csv,2016,0.001044970963626494,0.9989550290363735
673,Poltergeist,95437994,47425125,48012869,movies-2015.csv,2015,0.49692080703205055,0.5030791929679495
674,The Mortal Instruments: City of Bones,95396573,31165421,64231152,movies-2013.csv,2013,0.32669329746258285,0.6733067025374172
675,Truth or Dare,95330493,41411015,53919478,movies-2018.csv,2018,0.43439421843753606,0.565605781562464
676,Rush,95224595,26947624,68276971,movies-2013.csv,2013,0.28299016656358583,0.7170098334364142
677,The Hustle,95017038,35417038,59600000,movies-2019.csv,2019,0.3727440756467277,0.6272559243532723
678,I Feel Pretty,94539426,48795601,45743825,movies-2018.csv,2018,0.5161402291568811,0.48385977084311893
679,Veteran,94393020,1200627,93192393,movies-2015.csv,2015,0.01271944684045494,0.9872805531595451
680,Masquerade,94268432,922921,93345511,movies-2012.csv,2012,0.009790350602203715,0.9902096493977963
681,Police Story: Lockdown,94249025,0,94249025,movies-2013.csv,2013,0.0,1.0
682,Fleet of Time,94244191,569280,93674911,movies-2014.csv,2014,0.006040478399353017,0.9939595216006469
683,Dirty Grandpa,94073028,35593113,58479915,movies-2016.csv,2016,0.378356195784407,0.6216438042155931
684,Ben-Hur,94061311,26410477,67650834,movies-2016.csv,2016,0.2807793844166174,0.7192206155833827
685,Blockers,94017294,60311495,33705799,movies-2018.csv,2018,0.6414936277574634,0.35850637224253656
686,In the Heart of the Sea,93920758,25020758,68900000,movies-2015.csv,2015,0.26640285420183685,0.7335971457981632
687,Nothing to Declare,93811164,0,93811164,movies-2011.csv,2011,0.0,1.0
688,Kill Zone 2,93638358,11998,93626360,movies-2015.csv,2015,0.00012813125151126635,0.9998718687484888
689,The Internship,93492844,44672764,48820080,movies-2013.csv,2013,0.4778201420421011,0.5221798579578989
690,BlacKkKlansman,93400823,49275340,44125483,movies-2018.csv,2018,0.5275685847008008,0.47243141529919924
691,Goosebumps 2: Haunted Halloween,93320380,46700633,46619747,movies-2018.csv,2018,0.5004333780038187,0.49956662199618135
692,Money Monster,93282604,41012075,52270529,movies-2016.csv,2016,0.43965405382551287,0.5603459461744872
693,Train to Busan,92742323,2129768,90612555,movies-2016.csv,2016,0.022964359001445327,0.9770356409985547
694,Southpaw,91970827,52421953,39548874,movies-2015.csv,2015,0.5699845778270538,0.4300154221729462
695,Shadow,91708374,521396,91186978,movies-2018.csv,2018,0.005685369582498541,0.9943146304175015
696,Season of the Witch,91627228,24827228,66800000,movies-2011.csv,2011,0.2709590647007241,0.7290409352992759
697,Crawl,91542097,39014193,52527904,movies-2019.csv,2019,0.4261885436161682,0.5738114563838318
698,Five Feet Apart,91522094,45729221,45792873,movies-2019.csv,2019,0.49965225883052894,0.500347741169471
699,Rambo: Last Blood,91490353,44819352,46671001,movies-2019.csv,2019,0.4898806325514997,0.5101193674485003
700,Overboard,91244913,50316123,40928790,movies-2018.csv,2018,0.551440308787406,0.448559691212594
701,Paranormal Activity: The Marked Ones,90894962,32462372,58432590,movies-2014.csv,2014,0.35714159823291414,0.6428584017670859
702,My Big Fat Greek Wedding 2,90632641,59689605,30943036,movies-2016.csv,2016,0.6585883887020351,0.34141161129796493
703,Sherlock Gnomes,90497778,43242871,47254907,movies-2018.csv,2018,0.4778335110062039,0.522166488993796
704,Jojo Rabbit,90335025,33370906,56964119,movies-2019.csv,2019,0.369412705647671,0.630587294352329
705,Red Riding Hood,90260376,37662162,52598214,movies-2011.csv,2011,0.4172613019028416,0.5827386980971584
706,Detective Dee: The Four Heavenly Kings,90040771,262963,89777808,movies-2018.csv,2018,0.0029204880975530517,0.9970795119024469
707,Sucker Punch,89792502,36392502,53400000,movies-2011.csv,2011,0.4052955557469598,0.5947044442530401
708,The Hundred-Foot Journey,89514453,54240821,35273632,movies-2014.csv,2014,0.6059448411085079,0.39405515889149206
709,The Purge,89328627,64473115,24855512,movies-2013.csv,2013,0.7217519978226017,0.2782480021773983
710,The Inbetweeners,88823111,36000,88787111,movies-2011.csv,2011,0.00040529992244923735,0.9995947000775508
711,Collateral Beauty,88528280,31016021,57512259,movies-2016.csv,2016,0.350351559976089,0.649648440023911
712,This Is 40,88215156,67544505,20670651,movies-2012.csv,2012,0.7656791424820469,0.23432085751795304
713,Dhoom 3,88031955,8031955,80000000,movies-2013.csv,2013,0.09123908471645324,0.9087609152835467
714,Chasing the Dragon,87965942,456854,87509088,movies-2017.csv,2017,0.005193532742478902,0.9948064672575211
715,Tiger Zinda Hai,87320000,5560921,81759079,movies-2017.csv,2017,0.06368439074667888,0.9363156092533211
716,Pain & Gain,87305549,49875291,37430258,movies-2013.csv,2013,0.5712728637672274,0.42872713623277253
717,Sultan,87280000,6200000,81080000,movies-2016.csv,2016,0.07103574702108158,0.9289642529789184
718,A Million Ways to Die in the West,87189756,43139300,44050456,movies-2014.csv,2014,0.49477486781818725,0.5052251321818128
719,The Thieves,87126367,685839,86440528,movies-2012.csv,2012,0.007871773191231536,0.9921282268087684
720,About Time,87100449,15322921,71777528,movies-2013.csv,2013,0.17592241114623874,0.8240775888537613
721,Snowpiercer,86758912,4563650,82195262,movies-2013.csv,2013,0.052601512568530136,0.9473984874314698
722,The Lincoln Lawyer,86752352,58009200,28743152,movies-2011.csv,2011,0.6686758187259292,0.3313241812740708
723,Robin Hood,86489031,30824628,55664403,movies-2018.csv,2018,0.35639927564918605,0.643600724350814
724,A Taxi Driver,86252940,1527829,84725111,movies-2017.csv,2017,0.01771335562590678,0.9822866443740932
725,War Dogs,86234523,43034523,43200000,movies-2016.csv,2016,0.4990405408747956,0.5009594591252045
726,Step Up All In,86165646,14904384,71261262,movies-2014.csv,2014,0.1729736233858213,0.8270263766141787
727,Hall Pass,86157237,45060734,41096503,movies-2011.csv,2011,0.523005792305062,0.47699420769493805
728,I Can Only Imagine,86086881,83482352,2604529,movies-2018.csv,2018,0.9697453436604353,0.030254656339564676
729,John Wick,86013056,43037835,42975221,movies-2014.csv,2014,0.5003639796265348,0.49963602037346516
730,The Second Best Exotic Marigold Hotel,85978266,33078266,52900000,movies-2015.csv,2015,0.38472822887588826,0.6152717711241118
731,Spy Kids 4-D: All the Time in the World,85564310,38538188,47026122,movies-2011.csv,2011,0.45040026618574963,0.5495997338142503
732,Paper Towns,85512300,32000304,53511996,movies-2015.csv,2015,0.37421872642882953,0.6257812735711704
733,The Possession,85446075,49130154,36315921,movies-2012.csv,2012,0.5749843278348362,0.42501567216516384
734,Nerve,85251425,38583626,46667799,movies-2016.csv,2016,0.4525862881470896,0.5474137118529103
735,J. Edgar,84920539,37306030,47614509,movies-2011.csv,2011,0.4393051485459837,0.5606948514540163
736,Going in Style,84918541,45018541,39900000,movies-2017.csv,2017,0.5301379471416025,0.46986205285839755
737,Sicario,84872444,46889293,37983151,movies-2015.csv,2015,0.5524678068655593,0.44753219313444065
738,Carrie,84790678,35266619,49524059,movies-2013.csv,2013,0.41592566343201076,0.5840743365679892
739,The Judge,84419388,47119388,37300000,movies-2014.csv,2014,0.5581583699706517,0.44184163002934823
740,What to Expect When You're Expecting,84384002,41152203,43231799,movies-2012.csv,2012,0.4876777828100639,0.5123222171899361
741,Leap!,84197417,2844490,81352927,movies-2016.csv,2016,0.0337835779451524,0.9662164220548476
742,Finding Mr. Right,84112033,6945,84105088,movies-2013.csv,2013,8.256844772733052e-05,0.9999174315522726
743,Mortal Engines,83672673,15951040,67721633,movies-2018.csv,2018,0.19063619492591088,0.8093638050740891
744,Rings,83080890,27793018,55287872,movies-2017.csv,2017,0.33452961324800445,0.6654703867519955
745,Savages,82966152,47382068,35584084,movies-2012.csv,2012,0.5711011883496778,0.4288988116503222
746,Once Upon A Time,82886178,485728,82400450,movies-2017.csv,2017,0.005860180933906736,0.9941398190660933
747,"Big Mommas: Like Father, Like Son",82686066,37915414,44770652,movies-2011.csv,2011,0.4585465947793429,0.5414534052206571
748,Sinister,82515113,48086903,34428210,movies-2012.csv,2012,0.5827647960683275,0.4172352039316725
749,Act of Valor,82497035,70012847,12484188,movies-2012.csv,2012,0.8486710704208945,0.1513289295791055
750,Hitman: Agent 47,82347656,22467450,59880206,movies-2015.csv,2015,0.2728365455842483,0.7271634544157517
751,Abduction,82087155,28087155,54000000,movies-2011.csv,2011,0.34216260753585626,0.6578373924641437
752,Ouija: Origin of Evil,81705746,35144505,46561241,movies-2016.csv,2016,0.43013504827432825,0.5698649517256718
753,One Piece: Stampede,81562741,1298528,80264213,movies-2019.csv,2019,0.01592060276640286,0.9840793972335972
754,Frankenweenie,81491068,35291068,46200000,movies-2012.csv,2012,0.43306670124877983,0.5669332987512202
755,Tinker Tailor Soldier Spy,81244605,24149393,57095212,movies-2011.csv,2011,0.297243035399089,0.7027569646009111
756,Underworld: Blood Wars,81093313,30353973,50739340,movies-2016.csv,2016,0.37430919858953104,0.625690801410469
757,A Dog's Way Home,80708134,42004346,38703788,movies-2019.csv,2019,0.5204474929379485,0.4795525070620515
758,Go Away Mr. Tumor,80606893,286639,80320254,movies-2015.csv,2015,0.0035560110225312867,0.9964439889774687
759,Den of Thieves,80509622,44947622,35562000,movies-2018.csv,2018,0.5582888216764947,0.44171117832350526
760,Muppets Most Wanted,80383113,51183113,29200000,movies-2014.csv,2014,0.6367396221641727,0.36326037783582726
761,Hereditary,80200936,44069456,36131480,movies-2018.csv,2018,0.5494880508626483,0.4505119491373517
762,The Wedding Ringer,79799880,64460211,15339669,movies-2015.csv,2015,0.8077732823658381,0.19222671763416185
763,The Grey,79781695,51580236,28201459,movies-2012.csv,2012,0.6465171741462751,0.353482825853725
764,Manchester by the Sea,78988148,47695371,31292777,movies-2016.csv,2016,0.603829463124012,0.396170536875988
765,Lady Bird,78965611,48958273,30007338,movies-2017.csv,2017,0.6199948608008617,0.3800051391991382
766,Paranormal Activity: The Ghost Dimension,78903124,18300124,60603000,movies-2015.csv,2015,0.2319315519116835,0.7680684480883165
767,The Boss,78844582,63285885,15558697,movies-2016.csv,2016,0.8026662504216207,0.1973337495783794
768,The Attorney,78547586,557236,77990350,movies-2013.csv,2013,0.007094247301247424,0.9929057526987526
769,The Family,78418811,36918811,41500000,movies-2013.csv,2013,0.47079024189744473,0.5292097581025552
770,Scary Movie V,78378744,32015787,46362957,movies-2013.csv,2013,0.4084753769465864,0.5915246230534136
771,R.I.P.D.,78324220,33618855,44705365,movies-2013.csv,2013,0.4292268087700075,0.5707731912299925
772,Priest,78309505,29137000,49172505,movies-2011.csv,2011,0.37207488414082046,0.6279251158591795
773,If I Stay,78274843,50474843,27800000,movies-2014.csv,2014,0.6448411911857811,0.3551588088142189
774,Tag,78130625,54730625,23400000,movies-2018.csv,2018,0.7005015638874001,0.2994984361125999
775,Shin Godzilla,77947607,1918403,76029204,movies-2016.csv,2016,0.024611441888139043,0.975388558111861
776,Tiny Times,77717014,23462,77693552,movies-2013.csv,2013,0.0003018901369525082,0.9996981098630475
777,Diary of a Wimpy Kid: Dog Days,77229695,49008662,28221033,movies-2012.csv,2012,0.6345831354118386,0.3654168645881613
778,Mike and Dave Need Wedding Dates,77068246,46009673,31058573,movies-2016.csv,2016,0.596999093504736,0.40300090649526393
779,Drive,76976666,35061555,41915111,movies-2011.csv,2011,0.45548289919441304,0.544517100805587
780,"I, Frankenstein",76801179,19075290,57725889,movies-2014.csv,2014,0.248372358971208,0.751627641028792
781,Sanju,76693052,7909317,68783735,movies-2018.csv,2018,0.10312951165380665,0.8968704883461933
782,The Book Thief,76586316,21488481,55097835,movies-2013.csv,2013,0.28057859578987976,0.7194214042101202
783,Cold Pursuit,76419755,32138862,44280893,movies-2019.csv,2019,0.42055698817668286,0.5794430118233171
784,The Ides of March,76338111,40962534,35375577,movies-2011.csv,2011,0.5365934978401549,0.4634065021598452
785,Kubo and the Two Strings,76249438,48023088,28226350,movies-2016.csv,2016,0.6298156322148892,0.37018436778511077
786,The Mechanic,76130093,29121498,47008595,movies-2011.csv,2011,0.38252282182290254,0.6174771781770975
787,Vice,76073488,47836282,28237206,movies-2018.csv,2018,0.6288167304751426,0.3711832695248573
788,Widows,75984700,42402632,33582068,movies-2018.csv,2018,0.5580417110286676,0.4419582889713324
789,Sicario: Day of the Soldado,75837743,50072235,25765508,movies-2018.csv,2018,0.6602548153364743,0.33974518466352566
790,A Dog's Journey,75727748,22782371,52945377,movies-2019.csv,2019,0.30084574811335996,0.69915425188664
791,Bajrangi Bhaijaan,75547184,8178001,67369183,movies-2015.csv,2015,0.10825024265629808,0.8917497573437019
792,Searching,75462037,26020957,49441080,movies-2018.csv,2018,0.3448218208050758,0.6551781791949242
793,The Change-Up,75450437,37081475,38368962,movies-2011.csv,2011,0.49146799507602584,0.5085320049239741
794,The Spy Who Dumped Me,75320680,33562069,41758611,movies-2018.csv,2018,0.4455890334500432,0.5544109665499568
795,Larry Crowne,75055070,35608245,39446825,movies-2011.csv,2011,0.47442824315532584,0.5255717568446742
796,Tyler Perry's Boo! A Madea Halloween,74827344,73206343,1621001,movies-2016.csv,2016,0.9783367828744529,0.021663217125547047
797,A Madea Family Funeral,74747725,73257045,1490680,movies-2019.csv,2019,0.9800571856869222,0.019942814313077754
798,Crimson Peak,74679822,31090320,43589502,movies-2014.csv,2014,0.4163148648104705,0.5836851351895295
799,Escape from Planet Earth,74597643,57012977,17584666,movies-2013.csv,2013,0.7642731687916735,0.23572683120832652
800,August: Osage County,74188937,37738810,36450127,movies-2013.csv,2013,0.5086851426379111,0.4913148573620889
801,Miracles from Heaven,73983003,61705123,12277880,movies-2016.csv,2016,0.8340445845378837,0.16595541546211634
802,Cats,73834284,27166770,46667514,movies-2019.csv,2019,0.3679424859053282,0.6320575140946718
803,Charlie's Angels,73279888,17803077,55476811,movies-2019.csv,2019,0.24294629107511737,0.7570537089248827
804,War Room,73267874,67790117,5477757,movies-2015.csv,2015,0.9252365777666758,0.07476342223332426
805,To Rome With Love,73244881,16685867,56559014,movies-2012.csv,2012,0.22780932636097806,0.7721906736390219
806,Here Comes the Boom,73100172,45290318,27809854,movies-2012.csv,2012,0.6195651359069305,0.3804348640930694
807,The Best Man Holiday,72835710,70525195,2310515,movies-2013.csv,2013,0.9682777170703766,0.0317222829296234
808,The Transporter Refueled,72629670,16029670,56600000,movies-2015.csv,2015,0.22070415575342694,0.779295844246573
809,Diary of a Wimpy Kid: Rodrick Rules,72526996,52698535,19828461,movies-2011.csv,2011,0.7266057868989914,0.27339421310100864
810,Doctor Sleep,72381712,31581712,40800000,movies-2019.csv,2019,0.4363217051290525,0.5636782948709476
811,Second Act,72282227,39282227,33000000,movies-2018.csv,2018,0.5434562357908536,0.45654376420914644
812,What Men Want,72216294,54611903,17604391,movies-2019.csv,2019,0.7562268841987377,0.24377311580126224
813,Run All Night,71561644,26461644,45100000,movies-2015.csv,2015,0.3697741208963841,0.6302258791036159
814,Brick Mansions,71416730,20396829,51019901,movies-2014.csv,2014,0.28560295325759105,0.714397046742409
815,The Counselor,71009334,16973715,54035619,movies-2013.csv,2013,0.23903498376706364,0.7609650162329363
816,Son of God,70829270,59700064,11129206,movies-2014.csv,2014,0.842872784090532,0.15712721590946793
817,I Am Not Madame Bovary,70826207,436798,70389409,movies-2016.csv,2016,0.006167180461887504,0.9938328195381125
818,Spirited Away 2018 Re-release,70186029,1175067,69010962,movies-2018.csv,2018,0.016742178133485795,0.9832578218665142
819,Think Like a Man Too,70181428,65182182,4999246,movies-2014.csv,2014,0.9287668241803231,0.07123317581967696
820,The Cabin in the Woods,69935600,42073277,27862323,movies-2012.csv,2012,0.6016002865493397,0.39839971345066033
821,After,69746452,12138565,57607887,movies-2019.csv,2019,0.17403845861578737,0.8259615413842126
822,The Dilemma,69721966,48475290,21246676,movies-2011.csv,2011,0.6952656785380952,0.3047343214619048
823,Exit,69501772,470699,69031073,movies-2019.csv,2019,0.006772474808268198,0.9932275251917319
824,13 Hours,69411370,52853219,16558151,movies-2015.csv,2015,0.7614490104431018,0.23855098955689824
825,Finding Nemo 2012 3D Release,69328283,41128283,28200000,movies-2012.csv,2012,0.5932396017942634,0.4067603982057366
826,Anna Karenina,68929150,12816367,56112783,movies-2012.csv,2012,0.18593536986891612,0.8140646301310839
827,Running Man,68782475,310978,68471497,movies-2015.csv,2015,0.004521180722269735,0.9954788192777303
828,The Nut Job 2: Nutty by Nature,68743485,28370522,40372963,movies-2017.csv,2017,0.41270124725273966,0.5872987527472603
829,Playing with Fire,68631669,44451847,24179822,movies-2019.csv,2019,0.6476871049136224,0.3523128950863777
830,The Call,68572631,51872378,16700253,movies-2013.csv,2013,0.7564589143444124,0.24354108565558757
831,One Direction: This Is Us,68532898,28873374,39659524,movies-2013.csv,2013,0.4213067715303678,0.5786932284696322
832,Stalingrad,68316452,1013945,67302507,movies-2013.csv,2013,0.014841886109659207,0.9851581138903408
833,The Watch,68267862,35353000,32914862,movies-2012.csv,2012,0.5178571433802922,0.4821428566197078
834,Moonrise Kingdom,68263166,45512466,22750700,movies-2012.csv,2012,0.6667207026407185,0.3332792973592816
835,Shoplifters,67999335,3313513,64685822,movies-2018.csv,2018,0.04872860889007223,0.9512713911099278
836,A Beautiful Day in the Neighborhood,67760877,61704055,6056822,movies-2019.csv,2019,0.9106147637374882,0.08938523626251177
837,Jersey Boys,67647013,47047013,20600000,movies-2014.csv,2014,0.6954780545890474,0.30452194541095257
838,12 Strong,67450815,45819713,21631102,movies-2018.csv,2018,0.6793055502739292,0.32069444972607075
839,American Assassin,67234188,36249674,30984514,movies-2017.csv,2017,0.5391553773208356,0.4608446226791644
840,War,67179155,4654000,62525155,movies-2019.csv,2019,0.06927744178979328,0.9307225582102068
841,The Giver,66980456,45090374,21890082,movies-2014.csv,2014,0.6731870263767687,0.32681297362323125
842,Madea's Witness Protection,66899242,65653242,1246000,movies-2012.csv,2012,0.9813749758181116,0.018625024181888338
843,Mulan,66800000,0,66800000,movies-2020.csv,2020,0.0,1.0
844,Selma,66787908,52076908,14711000,movies-2014.csv,2014,0.779735577284439,0.22026442271556101
845,Victoria & Abdul,66558465,22245070,44313395,movies-2017.csv,2017,0.33421849497280326,0.6657815050271968
846,"Love, Simon",66316289,40826341,25489948,movies-2018.csv,2018,0.615630663531248,0.38436933646875204
847,Mile 22,66308758,36108758,30200000,movies-2018.csv,2018,0.5445548836851989,0.4554451163148011
848,One Piece Film: Gold,66207073,423593,65783480,movies-2016.csv,2016,0.00639800221949096,0.9936019977805091
849,Life of the Party,65859911,53059911,12800000,movies-2018.csv,2018,0.8056480823364611,0.1943519176635389
850,Beijing Love Story,65842375,428318,65414057,movies-2014.csv,2014,0.0065052027664554936,0.9934947972335445
851,The Age of Adaline,65663276,42629776,23033500,movies-2015.csv,2015,0.6492179281460158,0.35078207185398425
852,Moonlight,65336603,27854932,37481671,movies-2016.csv,2016,0.42632966394044086,0.5736703360595592
853,Something Borrowed,65100369,39046489,26053880,movies-2011.csv,2011,0.5997890580312993,0.40021094196870066
854,The Pirates,64858224,415775,64442449,movies-2014.csv,2014,0.006410520892462304,0.9935894791075377
855,God's Not Dead,64667874,60755732,3912142,movies-2014.csv,2014,0.9395040882277961,0.060495911772203925
856,The Darkest Hour,64626786,21443494,43183292,movies-2011.csv,2011,0.3318050506178661,0.6681949493821339
857,Happy Death Day 2U,64600152,28148130,36452022,movies-2019.csv,2019,0.43572854131984085,0.5642714586801592
858,Monster Trucks,64493915,33370166,31123749,movies-2016.csv,2016,0.5174157282900255,0.4825842717099745
859,Capernaum,64417003,1661096,62755907,movies-2018.csv,2018,0.025786607923997954,0.974213392076002
860,Fences,64414761,57682904,6731857,movies-2016.csv,2016,0.8954920130806664,0.10450798691933359
861,Zhongkui: Snow Girl and the Dark Crystal,64325947,165428,64160519,movies-2015.csv,2015,0.002571714956641058,0.9974282850433589
862,Isle of Dogs,64241499,32015231,32226268,movies-2018.csv,2018,0.49835747139088393,0.5016425286091161
863,Thunder and the House of Magic,64197205,4091,64193114,movies-2013.csv,2013,6.372551577595941e-05,0.9999362744842241
864,The Danish Girl,64191523,11114018,53077505,movies-2015.csv,2015,0.1731384064528271,0.8268615935471729
865,The Boy,64188367,35819556,28368811,movies-2015.csv,2015,0.5580381255064488,0.4419618744935511
866,The Grandmaster,64076736,6594959,57481777,movies-2013.csv,2013,0.10292282990194757,0.8970771700980524
867,Hanna,63782078,40259119,23522959,movies-2011.csv,2011,0.6311979832328448,0.3688020167671552
868,"Hail, Caesar!",63647656,30498085,33149571,movies-2016.csv,2016,0.4791705919225054,0.5208294080774947
869,Footloose 2011 Re-release,63543328,51802742,11740586,movies-2011.csv,2011,0.815234952755386,0.18476504724461396
870,Conan the Barbarian,63523283,21295021,42228262,movies-2011.csv,2011,0.33523174487061697,0.664768255129383
871,Begin Again,63464861,16170632,47294229,movies-2014.csv,2014,0.25479661887229216,0.7452033811277078
872,Colombiana,63458440,36665854,26792586,movies-2011.csv,2011,0.5777931824356224,0.42220681756437756
873,Side Effects,63414135,32172757,31241378,movies-2013.csv,2013,0.5073436229950941,0.49265637700490594
874,The Host,63365859,26627201,36738658,movies-2013.csv,2013,0.42021368320754554,0.5797863167924544
875,The Longest Ride,62944815,37446117,25498698,movies-2015.csv,2015,0.5949039170263667,0.4050960829736333
876,Unfriended,62882090,32482090,30400000,movies-2015.csv,2015,0.5165555088897331,0.4834444911102668
877,The Mountain Between Us,62832209,30348555,32483654,movies-2017.csv,2017,0.48300951825519933,0.5169904817448007
878,The Star,62812974,40852824,21960150,movies-2017.csv,2017,0.65038830990553,0.34961169009446996
879,The Nice Guys,62788218,36261763,26526455,movies-2016.csv,2016,0.5775249585837904,0.4224750414162097
880,Beauty and the Beast 2012 3D Release,62767829,47617067,15150762,movies-2012.csv,2012,0.7586221757008674,0.2413778242991326
881,Runner Runner,62675095,19316646,43358449,movies-2013.csv,2013,0.3082028994132358,0.6917971005867641
882,How to Be a Latin Lover,62547032,32149404,30397628,movies-2017.csv,2017,0.5140036700702281,0.4859963299297719
883,Andhadhun,62475342,1193046,61282296,movies-2018.csv,2018,0.019096270013215774,0.9809037299867842
884,47 Meters Down,62187529,44307191,17880338,movies-2017.csv,2017,0.7124771109654477,0.28752288903455225
885,Brooklyn,62076141,38322743,23753398,movies-2015.csv,2015,0.6173506017392415,0.3826493982607585
886,"Dragon Ball Z: Resurrection ""F""",61768190,8008363,53759827,movies-2015.csv,2015,0.1296518968744268,0.8703481031255732
887,White Snake,61631776,34730,61597046,movies-2019.csv,2019,0.000563508018980339,0.9994364919810197
888,"Everything, Everything",61621140,34121140,27500000,movies-2017.csv,2017,0.5537245821807256,0.4462754178192744
889,Woman in Gold,61619773,33307793,28311980,movies-2015.csv,2015,0.540537418078447,0.459462581921553
890,The Face Reader,61559184,515876,61043308,movies-2013.csv,2013,0.008380163063889865,0.9916198369361101
891,Krampus,61548707,42725475,18823232,movies-2015.csv,2015,0.694173396688902,0.305826603311098
892,From Up on Poppy Hill,61459425,1002895,60456530,movies-2011.csv,2011,0.0163180016734618,0.9836819983265382
893,Bombshell,61404394,31762808,29641586,movies-2019.csv,2019,0.5172725587032094,0.48272744129679057
894,The Legend of Hercules,61279452,18848538,42430914,movies-2013.csv,2013,0.30758333152195944,0.6924166684780406
895,Ashfall,61255955,372562,60883393,movies-2019.csv,2019,0.0060820535734035985,0.9939179464265964
896,The Walk,61181942,10137502,51044440,movies-2014.csv,2014,0.16569434817874856,0.8343056518212515
897,Ma,61105672,45896028,15209644,movies-2019.csv,2019,0.7510927627144007,0.24890723728559927
898,Snatched,60845711,45852178,14993533,movies-2017.csv,2017,0.7535811028652455,0.24641889713475448
899,Kick-Ass 2,60795985,28795985,32000000,movies-2013.csv,2013,0.4736494523445915,0.5263505476554085
900,Evangelion: 3.0 You Can (Not) Redo,60488344,174945,60313399,movies-2012.csv,2012,0.002892210109107963,0.997107789890892
901,My Little Pony: The Movie,60330833,21885107,38445726,movies-2017.csv,2017,0.3627516132588456,0.6372483867411544
902,The Perfect Guy,60273173,57027435,3245738,movies-2015.csv,2015,0.9461495415215655,0.05385045847843451
903,A Haunted House,60159584,40041683,20117901,movies-2013.csv,2013,0.6655910885288037,0.33440891147119634
904,Beautiful Creatures,60052138,19452138,40600000,movies-2013.csv,2013,0.323920823601651,0.676079176398349
905,Forever Young,59981902,149761,59832141,movies-2015.csv,2015,0.0024967697756566637,0.9975032302243433
906,Adrift,59945012,31445012,28500000,movies-2018.csv,2018,0.5245642790095696,0.47543572099043035
907,Quartet,59520298,18390117,41130181,movies-2012.csv,2012,0.3089721929819639,0.6910278070180361
908,Rock of Ages,59418613,38518613,20900000,movies-2012.csv,2012,0.6482583664482373,0.35174163355176263
909,Miss Granny,59396311,234573,59161738,movies-2015.csv,2015,0.003949285671967069,0.9960507143280329
910,One Day,59389433,13843771,45545662,movies-2011.csv,2011,0.23310158559688557,0.7668984144031145
911,Molly's Game,59284015,28780744,30503271,movies-2017.csv,2017,0.48547224745152634,0.5145277525484736
912,The Devotion of Suspect X,59035664,686435,58349229,movies-2017.csv,2017,0.011627463019641822,0.9883725369803582
913,The Gift,58978653,43787265,15191388,movies-2015.csv,2015,0.742425653566554,0.257574346433446
914,A Walk Among the Tombstones,58834384,26307600,32526784,movies-2014.csv,2014,0.44714668891578774,0.5528533110842122
915,Shock Wave,58815633,0,58815633,movies-2017.csv,2017,0.0,1.0
916,The Tree of Life,58409247,13303319,45105928,movies-2011.csv,2011,0.22776049484082547,0.7722395051591745
917,Beginning of the Great Revival,58309289,151000,58158289,movies-2011.csv,2011,0.0025896388481087464,0.9974103611518913
918,Huo guo ying xiong,58106427,779818,57326609,movies-2016.csv,2016,0.013420511985705126,0.9865794880142948
919,L.O.R.D: Legend of Ravaging Dynasties,58089494,350456,57739038,movies-2016.csv,2016,0.0060330358532646195,0.9939669641467354
920,Snitch,57824674,42930462,14894212,movies-2013.csv,2013,0.7424246265530179,0.25757537344698217
921,Dolphin Tale 2,57824533,42024533,15800000,movies-2014.csv,2014,0.7267595745217692,0.27324042547823085
922,Nine Lives,57814445,19700032,38114413,movies-2016.csv,2016,0.3407458464748732,0.6592541535251268
923,That's My Boy,57719093,36931089,20788004,movies-2012.csv,2012,0.6398418110970663,0.3601581889029337
924,Goldbuster,57628292,186135,57442157,movies-2017.csv,2017,0.0032299239408310073,0.996770076059169
925,Ready or Not,57615777,28714231,28901546,movies-2019.csv,2019,0.4983744469852416,0.5016255530147584
926,Killer Elite,57084522,25124966,31959556,movies-2011.csv,2011,0.44013622466699465,0.5598637753330054
927,The 15:17 to Paris,57076286,36276286,20800000,movies-2018.csv,2018,0.6355754472181319,0.36442455278186814
928,All the Money in the World,56996304,25113707,31882597,movies-2017.csv,2017,0.44061992160053043,0.5593800783994696
929,Zoolander 2,56722693,28848693,27874000,movies-2016.csv,2016,0.5085917377018754,0.4914082622981247
930,The Big Sick,56411585,42873127,13538458,movies-2017.csv,2017,0.7600057151381228,0.2399942848618772
931,The Odd Life of Timothy Green,56012642,51854875,4157767,movies-2012.csv,2012,0.9257709179295631,0.07422908207043688
932,Confidential Assignment,55972241,475618,55496623,movies-2017.csv,2017,0.008497390697649572,0.9915026093023505
933,Dallas Buyers Club,55736588,27298285,28438303,movies-2013.csv,2013,0.4897731630073947,0.5102268369926053
934,All Eyez on Me,55668698,44922302,10746396,movies-2017.csv,2017,0.806958014358446,0.1930419856415539
935,Lawless,55404159,37400127,18004032,movies-2012.csv,2012,0.6750418682467502,0.3249581317532498
936,Silent Hill: Revelation,55362705,17529157,37833548,movies-2011.csv,2011,0.31662392579986837,0.6833760742001317
937,Extremely Loud & Incredibly Close,55247881,31847881,23400000,movies-2011.csv,2011,0.5764543440136646,0.4235456559863355
938,End of Watch,55078146,41003371,14074775,movies-2012.csv,2012,0.744458083247755,0.2555419167522451
939,Hellboy,55064690,21903748,33160942,movies-2019.csv,2019,0.39778209956325916,0.6022179004367408
940,Barbershop: The Next Cut,55030051,54030051,1000000,movies-2016.csv,2016,0.9818281106081476,0.018171889391852464
941,Downsizing,55003890,24449754,30554136,movies-2017.csv,2017,0.44450954287051336,0.5554904571294866
942,St. Vincent,54837234,44137712,10699522,movies-2014.csv,2014,0.8048858190039272,0.19511418099607286
943,The Three Stooges,54819301,44338224,10481077,movies-2012.csv,2012,0.8088068105793614,0.19119318942063854
944,Early Man,54622814,8267544,46355270,movies-2018.csv,2018,0.15135697695838227,0.8486430230416178
945,The Age of Shadows,54491162,541719,53949443,movies-2016.csv,2016,0.009941410315309481,0.9900585896846905
946,No Escape,54418872,27288872,27130000,movies-2015.csv,2015,0.5014597141962075,0.4985402858037925
947,No Good Deed,54323210,52543632,1779578,movies-2014.csv,2014,0.9672409270365282,0.03275907296347178
948,The Five-Year Engagement,54169363,28835528,25333835,movies-2012.csv,2012,0.5323217110749484,0.4676782889250516
949,Tyler Perry's Madea's Big Happy Family,54161287,53345287,816000,movies-2011.csv,2011,0.9849338882955274,0.015066111704472605
950,"I, Tonya",53939297,30014539,23924758,movies-2017.csv,2017,0.5564503185868366,0.4435496814131634
951,Peppermint,53918723,35418723,18500000,movies-2018.csv,2018,0.6568909838610235,0.34310901613897643
952,Long Shot,53873809,30316271,23557538,movies-2019.csv,2019,0.5627274470234692,0.4372725529765308
953,Tyler Perry's A Madea Christmas,53396635,52543354,853281,movies-2013.csv,2013,0.9840199480735069,0.01598005192649312
954,Sinister 2,53329150,27740955,25588195,movies-2015.csv,2015,0.5201837081596088,0.4798162918403912
955,3 Days to Kill,53260230,30697999,22562231,movies-2014.csv,2014,0.5763775147046868,0.4236224852953132
956,Temptation: Confessions of a Marriage Counselor,53143144,51975354,1167790,movies-2013.csv,2013,0.9780255756038823,0.021974424396117777
957,Delivery Man,53120346,30664106,22456240,movies-2013.csv,2013,0.5772572716299702,0.4227427283700298
958,Found a Treasure Called Love,52715771,4364639,48351132,movies-2015.csv,2015,0.08279569694617575,0.9172043030538243
959,Wild,52501541,37880356,14621185,movies-2014.csv,2014,0.7215094124570554,0.2784905875429447
960,Teo-neol,52444295,568876,51875419,movies-2016.csv,2016,0.010847242774452398,0.9891527572255476
961,The Boy Next Door,52425855,35423380,17002475,movies-2015.csv,2015,0.6756853083273511,0.3243146916726489
962,The Night Before,52395996,43047372,9348624,movies-2015.csv,2015,0.8215775113808315,0.17842248861916854
963,Patriots Day,52185751,31886361,20299390,movies-2016.csv,2016,0.6110166163940038,0.3889833836059962
964,The Finest Hours,52099090,27569558,24529532,movies-2016.csv,2016,0.5291754232175648,0.47082457678243517
965,Teen Titans GO! To the Movies,52090236,29790236,22300000,movies-2018.csv,2018,0.5718967370391641,0.4281032629608359
966,"Yo-kai Watch Movie: It's the Secret of Birth, Meow!",51838845,257343,51581502,movies-2015.csv,2015,0.004964288845555876,0.9950357111544441
967,Slender Man,51738549,30569484,21169065,movies-2018.csv,2018,0.5908454061979975,0.4091545938020025
968,Master,51636415,597251,51039164,movies-2016.csv,2016,0.011566469128424194,0.9884335308715758
969,Breaking In,51411620,46840590,4571030,movies-2018.csv,2018,0.9110895552406246,0.08891044475937541
970,Hot Pursuit,51380201,34580201,16800000,movies-2015.csv,2015,0.6730258022929883,0.3269741977070117
971,Simmba,51329025,5102129,46226896,movies-2018.csv,2018,0.09940046591572702,0.900599534084273
972,Once Upon a Deadpool 2018 Re-release,51247568,6100309,45147259,movies-2018.csv,2018,0.11903606820912946,0.8809639317908705
973,The 100 Year-Old Man Who Climbed Out the Window and Disappeared,51167572,944193,50223379,movies-2013.csv,2013,0.018452956884489263,0.9815470431155108
974,Magic in the Moonlight,51029361,10539326,40490035,movies-2014.csv,2014,0.20653454782629946,0.7934654521737006
975,Red Dawn,50950296,44806783,6143513,movies-2012.csv,2012,0.8794214463444923,0.12057855365550771
976,War of the Arrows,50587661,251200,50336461,movies-2011.csv,2011,0.004965637766885486,0.9950343622331145
977,The Himalayas,50544493,696717,49847776,movies-2015.csv,2015,0.013784231647154914,0.9862157683528451
978,Dragon Ball Z: Battle of Gods,50461371,2553002,47908369,movies-2013.csv,2013,0.05059319533747904,0.9494068046625209
979,About Last Night,50445860,48637684,1808176,movies-2014.csv,2014,0.9641561071612219,0.03584389283877805
980,Breakthrough,50444358,40713082,9731276,movies-2019.csv,2019,0.8070889117074302,0.1929110882925698
981,Just Mercy,50401502,36001502,14400000,movies-2019.csv,2019,0.7142942287711981,0.28570577122880186
982,Red Tails,50365498,49876377,489121,movies-2012.csv,2012,0.9902885701636466,0.009711429836353449
983,"Monsters, Inc. 2012 3D Release",50207820,34043006,16164814,movies-2012.csv,2012,0.6780419066193274,0.32195809338067255
984,Uncut Gems,50023780,50023780,0,movies-2019.csv,2019,1.0,0.0
985,21 Bridges,49939757,28539757,21400000,movies-2019.csv,2019,0.5714836978481894,0.42851630215181064
986,Winnie the Pooh,49871429,26692846,23178583,movies-2011.csv,2011,0.535233229430823,0.464766770569177
987,The Wailing,49851770,786633,49065137,movies-2016.csv,2016,0.015779439727014708,0.9842205602729853
988,The Boy and the Beast,49714378,490643,49223735,movies-2015.csv,2015,0.009869237426645467,0.9901307625733545
989,Vanguard,49656971,0,49656971,movies-2020.csv,2020,0.0,1.0
990,Surprise,49567466,0,49567466,movies-2015.csv,2015,0.0,1.0
991,Death Wish,49562710,34017028,15545682,movies-2018.csv,2018,0.6863431801852643,0.3136568198147357
992,The Grudge,49511319,21221803,28289516,movies-2019.csv,2019,0.4286252806151256,0.5713747193848744
993,Entourage,49263404,32363404,16900000,movies-2015.csv,2015,0.6569461582476112,0.34305384175238884
994,Little,48987096,40860481,8126615,movies-2019.csv,2019,0.8341070268790786,0.16589297312092147
995,Whiplash,48982041,13092000,35890041,movies-2014.csv,2014,0.2672816349159481,0.732718365084052
996,Zhi qing chun 2: Yuan lai ni hai zai zhe li,48980792,96421,48884371,movies-2016.csv,2016,0.0019685471806989156,0.9980314528193011
997,The Berlin File,48972848,665210,48307638,movies-2013.csv,2013,0.013583241064518036,0.986416758935482
998,Trouble with the Curve,48963137,35763137,13200000,movies-2012.csv,2012,0.7304094302617906,0.2695905697382094
999,Luck-Key,48913975,466505,48447470,movies-2016.csv,2016,0.00953725392385305,0.9904627460761469
1000,Florence Foster Jenkins,48902953,27383770,21519183,movies-2016.csv,2016,0.559961481262696,0.44003851873730404
1001,The Woman in Black 2: Angel of Death,48854305,26501323,22352982,movies-2015.csv,2015,0.5424562482262311,0.457543751773769
1002,Fantasy Island,48811343,27309289,21502054,movies-2020.csv,2020,0.5594865316449088,0.44051346835509114
1003,Isn't It Romantic,48791187,48791187,0,movies-2019.csv,2019,1.0,0.0
1004,Mother's Day,48782670,32492859,16289811,movies-2016.csv,2016,0.6660738126879894,0.33392618731201057
1005,Concussion,48623572,34542474,14081098,movies-2015.csv,2015,0.7104059323325732,0.28959406766742685
1006,Her,48517427,25568251,22949176,movies-2013.csv,2013,0.5269910747740189,0.47300892522598115
1007,Logan Lucky,48453605,27780977,20672628,movies-2017.csv,2017,0.5733521169374292,0.4266478830625709
1008,Homefront,48449416,20158898,28290518,movies-2013.csv,2013,0.4160813414138986,0.5839186585861015
1009,Chef,48428048,31424003,17004045,movies-2014.csv,2014,0.6488802315550691,0.3511197684449309
1010,Boo 2! A Madea Halloween,48333932,47319572,1014360,movies-2017.csv,2017,0.979013501322425,0.020986498677575
1011,The Last Stand,48330757,12050299,36280458,movies-2013.csv,2013,0.24932982117370933,0.7506701788262907
1012,Arthur,48147945,33035397,15112548,movies-2011.csv,2011,0.6861226787560715,0.3138773212439285
1013,Boyhood,48137666,25352281,22785385,movies-2014.csv,2014,0.5266620321807874,0.4733379678192125
1014,21 & Over,48065672,25682380,22383292,movies-2013.csv,2013,0.5343185465086184,0.4656814534913815
1015,Countdown,48021766,25621766,22400000,movies-2019.csv,2019,0.5335448513076341,0.4664551486923659
1016,After We Collided,47984832,2380901,45603931,movies-2020.csv,2020,0.04961778338621671,0.9503822166137833
1017,Midsommar,47863365,27426361,20437004,movies-2019.csv,2019,0.5730136399728686,0.4269863600271314
1018,Queen & Slim,47802566,43808310,3994256,movies-2019.csv,2019,0.9164426445224718,0.08355735547752813
1019,Phantom Thread,47756590,21198205,26558385,movies-2017.csv,2017,0.4438802058522185,0.5561197941477815
1020,Man on a Ledge,47636031,18620000,29016031,movies-2012.csv,2012,0.3908805920459662,0.6091194079540337
1021,Coming Home,47587984,377607,47210377,movies-2014.csv,2014,0.007934923236084135,0.9920650767639159
1022,47 Meters Down: Uncaged,47582563,22260900,25321663,movies-2019.csv,2019,0.46783734621441053,0.5321626537855895
1023,Beauty and the Beast,47430624,0,47430624,movies-2014.csv,2014,0.0,1.0
1024,Nightcrawler,47398992,32381217,15017775,movies-2014.csv,2014,0.683162565988745,0.3168374340112549
1025,Rough Night,47347283,22105643,25241640,movies-2017.csv,2017,0.466883031070653,0.533116968929347
1026,Texas Chainsaw,47340586,34341945,12998641,movies-2013.csv,2013,0.7254228961170865,0.2745771038829135
1027,A Monster Calls,47309313,3740823,43568490,movies-2016.csv,2016,0.07907159843982516,0.9209284015601749
1028,Tiny Times 2.0,47289937,43788,47246149,movies-2013.csv,2013,0.0009259475224084143,0.9990740524775916
1029,Golden Job,47287851,285795,47002056,movies-2018.csv,2018,0.006043729921243407,0.9939562700787566
1030,Mortdecai,47275695,7696134,39579561,movies-2015.csv,2015,0.16279261468287246,0.8372073853171276
1031,Soul Surfer,47120948,43853424,3267524,movies-2011.csv,2011,0.9306566582658736,0.0693433417341264
1032,The Place Beyond the Pines,47052899,21403519,25649380,movies-2013.csv,2013,0.45488204669387106,0.5451179533061289
1033,Son of Bigfoot,47046281,289308,46756973,movies-2017.csv,2017,0.006149434000957483,0.9938505659990425
1034,Parker,46922566,17616641,29305925,movies-2013.csv,2013,0.3754406994706982,0.6245593005293019
1035,Mary Queen of Scots,46712809,16468499,30244310,movies-2018.csv,2018,0.35254782044899075,0.6474521795510092
1036,Uncle Drew,46664414,42469946,4194468,movies-2018.csv,2018,0.9101142039413588,0.08988579605864118
1037,The Big Wedding,46522137,21819348,24702789,movies-2013.csv,2013,0.4690100112984922,0.5309899887015078
1038,Risen,46432579,36880033,9552546,movies-2016.csv,2016,0.7942706133122608,0.20572938668773924
1039,Tyler Perry's Acrimony,46403669,43549096,2854573,movies-2018.csv,2018,0.9384838944523978,0.061516105547602284
1040,A Werewolf Boy,46282588,342922,45939666,movies-2012.csv,2012,0.007409309090494248,0.9925906909095058
1041,The Thousand Faces of Dunjia,46263237,124187,46139050,movies-2017.csv,2017,0.002684356047113608,0.9973156439528864
1042,Asterix: The Secret of the Magic Potion,46221204,1271953,44949251,movies-2018.csv,2018,0.027518820150163114,0.9724811798498368
1043,The Battleship Island,46183383,1104957,45078426,movies-2017.csv,2017,0.023925423566307388,0.9760745764336927
1044,Eddie the Eagle,46152800,15789389,30363411,movies-2016.csv,2016,0.342111182853478,0.657888817146522
1045,The World's End,46089287,26004851,20084436,movies-2013.csv,2013,0.5642276696534707,0.43577233034652935
1046,Let's Get Married,45972724,462918,45509806,movies-2015.csv,2015,0.010069405502271303,0.9899305944977287
1047,The New Mutants,45863139,23771361,22091778,movies-2020.csv,2020,0.5183108160128334,0.4816891839871667
1048,Somewhere Only We Know,45737711,482341,45255370,movies-2015.csv,2015,0.010545805407708313,0.9894541945922917
1049,Chasing the Dragon II: Wild Wild Bunch,45733356,196634,45536722,movies-2019.csv,2019,0.004299575128490461,0.9957004248715096
1050,"McFarland, USA",45710059,44482410,1227649,movies-2015.csv,2015,0.9731426949153577,0.026857305084642312
1051,Earth to Echo,45681062,38934842,6746220,movies-2014.csv,2014,0.8523191076424624,0.14768089235753756
1052,That Awkward Moment,45640143,26068955,19571188,movies-2014.csv,2014,0.5711847791537376,0.42881522084626245
1053,The Debt,45636368,31177548,14458820,movies-2011.csv,2011,0.6831732972264576,0.31682670277354236
1054,Hero,45565534,88675,45476859,movies-2015.csv,2015,0.0019460981188105905,0.9980539018811894
1055,Love on the Cloud,45386560,271734,45114826,movies-2014.csv,2014,0.005987102789900799,0.9940128972100992
1056,Blair Witch,45173154,20777061,24396093,movies-2016.csv,2016,0.4599426686035693,0.5400573313964308
1057,Flatliners,45158254,16883115,28275139,movies-2017.csv,2017,0.3738655396198445,0.6261344603801555
1058,Grudge Match,44907260,29807260,15100000,movies-2013.csv,2013,0.6637514735924659,0.3362485264075341
1059,Child's Play,44907074,29208403,15698671,movies-2019.csv,2019,0.6504187513976083,0.3495812486023917
1060,Still Alice,44779195,18754371,26024824,movies-2015.csv,2015,0.41881885103115407,0.5811811489688459
1061,Mother!,44516999,17800004,26716995,movies-2017.csv,2017,0.3998473482006278,0.6001526517993722
1062,Oculus,44446287,27695246,16751041,movies-2014.csv,2014,0.6231172021185931,0.37688279788140683
1063,House at the End of the Street,44287131,31611916,12675215,movies-2012.csv,2012,0.7137946235442526,0.2862053764557474
1064,Winchester,44019588,25091816,18927772,movies-2018.csv,2018,0.5700147852360635,0.4299852147639365
1065,Kick,43996483,2472695,41523788,movies-2014.csv,2014,0.056202105972879696,0.9437978940271203
1066,Wind River,43980821,33800859,10179962,movies-2017.csv,2017,0.7685363354176585,0.23146366458234147
1067,Max,43967255,42656255,1311000,movies-2015.csv,2015,0.9701823550276223,0.029817644972377738
1068,Battle of Memories,43892362,594552,43297810,movies-2017.csv,2017,0.01354568250393998,0.98645431749606
1069,Café Society,43763247,11103205,32660042,movies-2016.csv,2016,0.25371072215002693,0.746289277849973
1070,Richard Jewell,43745542,22345542,21400000,movies-2019.csv,2019,0.5108072955182497,0.4891927044817504
1071,The DUFF,43709744,34030343,9679401,movies-2015.csv,2015,0.7785527867653491,0.22144721323465083
1072,Judy,43660268,24313888,19346380,movies-2019.csv,2019,0.5568881986706998,0.4431118013293001
1073,League of Gods,43498766,181633,43317133,movies-2016.csv,2016,0.004175589716728976,0.9958244102832711
1074,Harriet,43347017,43082155,264862,movies-2019.csv,2019,0.9938897294824232,0.006110270517576792
1075,Beastly,43202283,27865571,15336712,movies-2011.csv,2011,0.6450022791619601,0.35499772083804
1076,The Snowman,43155261,6700035,36455226,movies-2017.csv,2017,0.1552541878961177,0.8447458121038823
1077,Annihilation,43070915,32732301,10338614,movies-2018.csv,2018,0.7599629819798349,0.2400370180201651
1078,Gifted,43046590,24801212,18245378,movies-2017.csv,2017,0.5761481223019059,0.42385187769809407
1079,The Possession of Hannah Grace,43016528,14837422,28179106,movies-2018.csv,2018,0.3449237465190124,0.6550762534809876
1080,Legend,42972994,1872994,41100000,movies-2015.csv,2015,0.04358537364187378,0.9564146263581262
1081,The Gallows,42964410,22764410,20200000,movies-2015.csv,2015,0.5298434215668271,0.47015657843317293
1082,Unhinged,42831465,20831465,22000000,movies-2020.csv,2020,0.4863589186127535,0.5136410813872465
1083,Xin Shao Lin si,42741494,66099,42675395,movies-2011.csv,2011,0.001546483143523247,0.9984535168564768
1084,Almost Christmas,42580920,42158780,422140,movies-2016.csv,2016,0.9900861700498721,0.009913829950127897
1085,Love the Coopers,42426912,26302731,16124181,movies-2015.csv,2015,0.6199539339558816,0.3800460660441184
1086,Loving Vincent,42187665,6735118,35452547,movies-2017.csv,2017,0.15964661708582353,0.8403533829141765
1087,Long Day's Journey Into Night,42140994,521365,41619629,movies-2018.csv,2018,0.01237191984602926,0.9876280801539707
1088,Jobs,42128352,16131410,25996942,movies-2013.csv,2013,0.3829110144161348,0.6170889855838653
1089,Bang Bang,42045981,2546172,39499809,movies-2014.csv,2014,0.060556846087144456,0.9394431539128556
1090,Mary and the Witch's Flower,41978431,2418404,39560027,movies-2017.csv,2017,0.05761063342267366,0.9423893665773263
1091,"As Above, So Below",41898409,21321100,20577309,movies-2014.csv,2014,0.5088761246280259,0.49112387537197416
1092,Call Me by Your Name,41887595,18095701,23791894,movies-2017.csv,2017,0.4320062061333433,0.5679937938666567
1093,The Guilt Trip,41863726,37134215,4729511,movies-2012.csv,2012,0.8870260377683534,0.11297396223164656
1094,T2 Trainspotting,41681746,2402004,39279742,movies-2017.csv,2017,0.05762724047116452,0.9423727595288355
1095,Overlord,41657844,21704844,19953000,movies-2018.csv,2018,0.5210265802522089,0.47897341974779106
1096,Born to Be Wild,41644475,25978556,15665919,movies-2011.csv,2011,0.6238175892480335,0.3761824107519665
1097,Safe,41564670,17142080,24422590,movies-2012.csv,2012,0.4124194899177595,0.5875805100822405
1098,The Great Battle,41509280,472166,41037114,movies-2018.csv,2018,0.0113749503725432,0.9886250496274568
1099,The Lady in the Van,41387687,10021175,31366512,movies-2015.csv,2015,0.24212938017048405,0.757870619829516
1100,Shark Night,41363927,18877153,22486774,movies-2011.csv,2011,0.45636752525938845,0.5436324747406115
1101,Ricki and the Flash,41325328,26822144,14503184,movies-2015.csv,2015,0.6490485447568619,0.35095145524313803
1102,This Is Where I Leave You,41296320,34296320,7000000,movies-2014.csv,2014,0.8304933708378858,0.1695066291621142
1103,The Darkest Minds,41142379,12695691,28446688,movies-2018.csv,2018,0.30857940908084097,0.6914205909191591
1104,50/50,41097853,35014192,6083661,movies-2011.csv,2011,0.8519713183070659,0.14802868169293418
1105,Fist Fight,41087017,32187017,8900000,movies-2017.csv,2017,0.7833865622320549,0.21661343776794503
1106,Dredd,41037742,13414714,27623028,movies-2012.csv,2012,0.32688723468264896,0.6731127653173511
1107,Fright Night,41002607,18302607,22700000,movies-2011.csv,2011,0.4463766657568871,0.5536233342431128
1108,Drive Angry,40909909,10721033,30188876,movies-2011.csv,2011,0.262064454848824,0.737935545151176
1109,Underwater,40882928,17291078,23591850,movies-2020.csv,2020,0.4229412824834855,0.5770587175165145
1110,Fighting with My Family,40811919,22958886,17853033,movies-2019.csv,2019,0.5625534540534592,0.43744654594654075
1111,30 Minutes or Less,40662632,37053924,3608708,movies-2011.csv,2011,0.9112524737700206,0.0887475262299794
1112,The Circle,40656399,20497844,20158555,movies-2017.csv,2017,0.504172639588666,0.495827360411334
1113,The Roommate,40492652,37300000,3192652,movies-2011.csv,2011,0.9211547813662587,0.07884521863374125
1114,Holmes & Watson,40466970,30573626,9893344,movies-2018.csv,2018,0.7555205146320567,0.24447948536794328
1115,The Witch,40423945,25138705,15285240,movies-2016.csv,2016,0.6218765882449128,0.37812341175508724
1116,Carol,40272135,12711491,27560644,movies-2015.csv,2015,0.3156398586764769,0.6843601413235231
1117,Diary of a Wimpy Kid: The Long Haul,40140972,20738724,19402248,movies-2017.csv,2017,0.5166472799911273,0.48335272000887275
1118,The Wild Life,40075446,8005586,32069860,movies-2016.csv,2016,0.19976286726790266,0.8002371327320974
1119,Northern Limit Line,40034677,337907,39696770,movies-2015.csv,2015,0.008440357842777151,0.9915596421572228
1120,Dream House,39984400,21302340,18682060,movies-2011.csv,2011,0.532766278848751,0.467233721151249
1121,Brotherhood of Blades 2,39966092,14204,39951888,movies-2017.csv,2017,0.0003554012736596813,0.9996445987263404
1122,Monte Carlo,39782683,23186769,16595914,movies-2011.csv,2011,0.5828357277964384,0.41716427220356156
1123,The Forest,39712000,26594261,13117739,movies-2016.csv,2016,0.6696782080983078,0.3303217919016922
1124,The November Man,39661919,25018119,14643800,movies-2014.csv,2014,0.6307843803523475,0.3692156196476524
1125,Thugs of Hindostan,39570044,1449848,38120196,movies-2018.csv,2018,0.0366400401273246,0.9633599598726754
1126,Don Jon,39439355,24477704,14961651,movies-2013.csv,2013,0.6206415901071405,0.37935840989285957
1127,Frank Miller's Sin City: A Dame to Kill For,39407616,13757804,25649812,movies-2014.csv,2014,0.3491153588179503,0.6508846411820497
1128,Uri: The Surgical Strike,39346577,4186168,35160409,movies-2019.csv,2019,0.10639217739322025,0.8936078226067797
1129,The Gambler,39280992,33680992,5600000,movies-2014.csv,2014,0.8574374089126874,0.14256259108731267
1130,Mars Needs Moms,39233678,21392758,17840920,movies-2011.csv,2011,0.5452651673391417,0.45473483266085835
1131,Absolutely Fabulous: The Movie,39219109,4772155,34446954,movies-2016.csv,2016,0.12167933238870877,0.8783206676112912
1132,Samba,39178695,151530,39027165,movies-2014.csv,2014,0.0038676632797493638,0.9961323367202506
1133,Show Dogs,39156854,17857020,21299834,movies-2018.csv,2018,0.4560381689499366,0.5439618310500635
1134,Women Who Flirt,39156132,375495,38780637,movies-2014.csv,2014,0.009589685722787941,0.990410314277212
1135,Believer,39047153,365639,38681514,movies-2018.csv,2018,0.009364037372968011,0.990635962627032
1136,The Spy Gone North,38844509,500803,38343706,movies-2018.csv,2018,0.012892504317663018,0.987107495682337
1137,Criminal,38803993,14708696,24095297,movies-2015.csv,2015,0.3790510940459143,0.6209489059540857
1138,Train to Busan Presents: Peninsula,38700977,1231407,37469570,movies-2020.csv,2020,0.03181849905236243,0.9681815009476376
1139,On the Basis of Sex,38673750,24622687,14051063,movies-2018.csv,2018,0.6366769966708685,0.36332300332913153
1140,"Crouching Tiger, Hidden Dragon: Sword of Destiny",38659039,0,38659039,movies-2016.csv,2016,0.0,1.0
1141,The Best of Me,38609668,26766213,11843455,movies-2014.csv,2014,0.6932515710831805,0.30674842891681947
1142,Million Dollar Arm,38483455,36457627,2025828,movies-2014.csv,2014,0.9473584687237672,0.05264153127623286
1143,Chernobyl Diaries,38390020,18119640,20270380,movies-2012.csv,2012,0.4719882927906784,0.5280117072093216
1144,Boruto: Naruto The Movie,38362448,919651,37442797,movies-2015.csv,2015,0.023972688082887723,0.9760273119171122
1145,The Lazarus Effect,38356892,25801570,12555322,movies-2015.csv,2015,0.6726710287162996,0.3273289712837005
1146,Don't Be Afraid of the Dark,38269529,24046682,14222847,movies-2011.csv,2011,0.6283506128335157,0.3716493871664843
1147,The Water Diviner,38176317,4196641,33979676,movies-2014.csv,2014,0.10992786444014492,0.8900721355598551
1148,Jumping the Broom,38158601,37295394,863207,movies-2011.csv,2011,0.9773784421499101,0.022621557850089943
1149,Greenland,38100000,0,38100000,movies-2020.csv,2020,0.0,1.0
1150,One for the Money,38080789,26414527,11666262,movies-2011.csv,2011,0.6936444252770078,0.30635557472299224
1151,But Always,38039248,430760,37608488,movies-2014.csv,2014,0.011324093473141214,0.9886759065268588
1152,Overcomer,38026103,34746945,3279158,movies-2019.csv,2019,0.9137656046426845,0.08623439535731547
1153,The Eagle,37989684,19490041,18499643,movies-2011.csv,2011,0.5130350913158425,0.48696490868415754
1154,Killing Them Softly,37930465,15026056,22904409,movies-2012.csv,2012,0.39614742397700636,0.6038525760229937
1155,Hell or High Water,37879877,27007844,10872033,movies-2016.csv,2016,0.7129865812394269,0.28701341876057307
1156,The Handmaiden,37692886,2006788,35686098,movies-2016.csv,2016,0.05324049742436809,0.9467595025756319
1157,Pokémon the Movie: I Choose You!,37552144,2401722,35150422,movies-2017.csv,2017,0.06395698738266449,0.9360430126173355
1158,A Walk in the Woods,37461274,29504281,7956993,movies-2015.csv,2015,0.7875941699153104,0.21240583008468958
1159,Pain and Glory,37359689,4567338,32792351,movies-2019.csv,2019,0.12225310547954508,0.877746894520455
1160,Snowden,37357216,21587519,15769697,movies-2016.csv,2016,0.5778674460109662,0.4221325539890339
1161,Home Again,37270721,27020284,10250437,movies-2017.csv,2017,0.7249734718037786,0.27502652819622136
1162,"Like Father, Like Son",37170163,334616,36835547,movies-2013.csv,2013,0.009002274216553745,0.9909977257834462
1163,Till The End Of The World,37013733,118660,36895073,movies-2018.csv,2018,0.003205837141582018,0.9967941628584179
1164,2.0,36945969,4152000,32793969,movies-2018.csv,2018,0.11238032490093845,0.8876196750990616
1165,Devil's Due,36921560,15821461,21100099,movies-2014.csv,2014,0.42851550692874296,0.571484493071257
1166,Ex Machina,36869414,25442958,11426456,movies-2015.csv,2015,0.6900830590906598,0.3099169409093402
1167,The Adventurers,36796816,216556,36580260,movies-2017.csv,2017,0.0058851831093211975,0.9941148168906788
1168,Burnt,36606743,13651946,22954797,movies-2015.csv,2015,0.3729352813496683,0.6270647186503318
1169,The Intruder,36599361,35419122,1180239,movies-2019.csv,2019,0.9677524697767265,0.03224753022327357
1170,The Priests,36577134,185093,36392041,movies-2015.csv,2015,0.005060347265042691,0.9949396527349573
1171,A Most Wanted Man,36233517,17237855,18995662,movies-2014.csv,2014,0.4757433566275115,0.5242566433724886
1172,A Very Harold & Kumar Christmas,36192775,35061031,1131744,movies-2011.csv,2011,0.9687301125708101,0.031269887429189944
1173,Nothing to Lose,36075317,1016188,35059129,movies-2018.csv,2018,0.028168512005036575,0.9718314879949634
1174,Kundo: Age of the Rampant,35941291,280958,35660333,movies-2014.csv,2014,0.00781713711953196,0.9921828628804681
1175,Ra.One,35911689,2511689,33400000,movies-2011.csv,2011,0.06994070927713815,0.9300592907228619
1176,Conquest 1453,35797045,35730,35761315,movies-2012.csv,2012,0.0009981270800425008,0.9990018729199575
1177,Tad the Lost Explorer and the Secret of King Midas,35704046,5874,35698172,movies-2017.csv,2017,0.00016451916962016014,0.9998354808303799
1178,Hostiles,35669017,29819114,5849903,movies-2017.csv,2017,0.835994835517895,0.164005164482105
1179,Tyler Perry's Good Deeds,35579177,35025791,553386,movies-2012.csv,2012,0.9844463518647438,0.015553648135256191
1180,Mia and the White Lion,35487190,399471,35087719,movies-2018.csv,2018,0.011256766173934877,0.9887432338260651
1181,Arbitrage,35485056,7919574,27565482,movies-2012.csv,2012,0.22318054112694652,0.7768194588730535
1182,Room,35401758,14677654,20724104,movies-2015.csv,2015,0.4146024047732319,0.5853975952267682
1183,Namiya,35351623,70814,35280809,movies-2017.csv,2017,0.0020031329254670996,0.997996867074533
1184,Eye in the Sky,35259653,18704595,16555058,movies-2016.csv,2016,0.5304815393390286,0.46951846066097136
1185,Courageous,35185884,34522221,663663,movies-2011.csv,2011,0.9811383735591239,0.01886162644087612
1186,The Girl in the Spider's Web,35164920,14841338,20323582,movies-2018.csv,2018,0.42204953118050603,0.577950468819494
1187,My Week with Marilyn,35057696,14600347,20457349,movies-2011.csv,2011,0.4164662446727817,0.5835337553272183
1188,When Marnie Was There,34949567,561085,34388482,movies-2014.csv,2014,0.016054133088401354,0.9839458669115987
1189,The Sitter,34942188,30441326,4500862,movies-2011.csv,2011,0.8711911801287315,0.12880881987126852
1190,The Hate U Give,34934009,29719483,5214526,movies-2018.csv,2018,0.8507321046376326,0.14926789536236737
1191,Lost and Love,34930177,188817,34741360,movies-2015.csv,2015,0.005405555202311171,0.9945944447976889
1192,Secret in Their Eyes,34854990,20180155,14674835,movies-2015.csv,2015,0.578974631752871,0.42102536824712905
1193,Chimpanzee,34823764,28972764,5851000,movies-2012.csv,2012,0.8319825507661952,0.16801744923380482
1194,Kidnap,34814102,30971040,3843062,movies-2017.csv,2017,0.8896119164584513,0.11038808354154876
1195,Broken City,34737199,19701164,15036035,movies-2013.csv,2013,0.5671488941868917,0.4328511058131083
1196,Endless Love,34718173,23438250,11279923,movies-2014.csv,2014,0.6751003285800782,0.32489967141992177
1197,Jane Eyre,34710627,11242660,23467967,movies-2011.csv,2011,0.3238967708650149,0.6761032291349851
1198,The Man Standing Next,34664900,113527,34551373,movies-2020.csv,2020,0.003274984205925879,0.9967250157940741
1199,Alex Cross,34618867,25888412,8730455,movies-2012.csv,2012,0.7478122262060165,0.2521877737939835
1200,Trolls World Tour,34572374,0,34572374,movies-2020.csv,2020,0.0,1.0
1201,Salmon Fishing in the Yemen,34564651,9047981,25516670,movies-2012.csv,2012,0.2617697774526929,0.7382302225473071
1202,Haywire,34513760,18942396,15571364,movies-2012.csv,2012,0.548836058430029,0.4511639415699709
1203,Steve Jobs,34441873,17766658,16675215,movies-2015.csv,2015,0.515844710303647,0.484155289696353
1204,Victor Frankenstein,34227298,5775076,28452222,movies-2015.csv,2015,0.16872719546836562,0.8312728045316343
1205,The House,34184504,25584504,8600000,movies-2017.csv,2017,0.748424022767743,0.25157597723225705
1206,Cirque du Soleil: Worlds Away,34153101,12512862,21640239,movies-2012.csv,2012,0.36637557450493297,0.633624425495067
1207,The Bad Guys: The Movie,34024386,166972,33857414,movies-2019.csv,2019,0.004907421400638942,0.9950925785993611
1208,The Witness,33963557,418063,33545494,movies-2015.csv,2015,0.012309164202088727,0.9876908357979113
1209,The Good Liar,33856058,17156058,16700000,movies-2019.csv,2019,0.5067352495674482,0.49326475043255186
1210,The Art of Racing in the Rain,33766787,26395642,7371145,movies-2019.csv,2019,0.7817042823766442,0.21829571762335576
1211,I Want to Eat Your Pancreas,33748006,277019,33470987,movies-2017.csv,2017,0.008208455338072419,0.9917915446619275
1212,Nobody's Fool,33705333,31713110,1992223,movies-2018.csv,2018,0.9408929441521909,0.05910705584780901
1213,The Skin I Live In,33678406,3185812,30492594,movies-2011.csv,2011,0.09459509455405936,0.9054049054459407
1214,Bloodshot,33482340,12561824,20920516,movies-2020.csv,2020,0.3751776010876181,0.6248223989123819
1215,2016: Obama's America,33449086,33449086,0,movies-2012.csv,2012,1.0,0.0
1216,Get on Up,33448971,30703100,2745871,movies-2014.csv,2014,0.9179086555457865,0.08209134445421355
1217,The Perks of Being a Wallflower,33384127,17742948,15641179,movies-2012.csv,2012,0.5314785676438386,0.46852143235616134
1218,Perfect Strangers,33262366,1014507,32247859,movies-2017.csv,2017,0.03050014541960124,0.9694998545803988
1219,Project Almanac,33213241,22348241,10865000,movies-2015.csv,2015,0.6728714310054836,0.32712856899451637
1220,Bharat,33185983,2971549,30214434,movies-2019.csv,2019,0.08954229259986062,0.9104577074001394
1221,Baaghi 2,33139063,1319579,31819484,movies-2018.csv,2018,0.039819442088631175,0.9601805579113688
1222,Lockout,32948113,14326864,18621249,movies-2012.csv,2012,0.43483109336185655,0.5651689066381435
1223,Inside Llewyn Davis,32935319,13235319,19700000,movies-2013.csv,2013,0.40185792644060925,0.5981420735593908
1224,Sleepless,32917353,20783704,12133649,movies-2017.csv,2017,0.6313905009312262,0.3686094990687738
1225,Brightburn,32893421,17300439,15592982,movies-2019.csv,2019,0.5259543846169117,0.4740456153830883
1226,Katy Perry: Part of Me,32726956,25326071,7400885,movies-2012.csv,2012,0.7738596586862524,0.2261403413137476
1227,Mud,32613173,21590086,11023087,movies-2013.csv,2013,0.6620050738393348,0.3379949261606652
1228,The Hurricane Heist,32517248,6115825,26401423,movies-2018.csv,2018,0.18807941557661953,0.8119205844233804
1229,UglyDolls,32450241,20150241,12300000,movies-2019.csv,2019,0.6209581309426947,0.3790418690573053
1230,Movie 43,32438988,8840453,23598535,movies-2012.csv,2012,0.2725255485775327,0.7274744514224674
1231,Stuber,32390945,22370452,10020493,movies-2019.csv,2019,0.6906390659488323,0.3093609340511677
1232,Kevin Hart: Let Me Explain,32318051,32244051,74000,movies-2013.csv,2013,0.997710257960791,0.002289742039208986
1233,Seven Psychopaths,32226382,15024049,17202333,movies-2012.csv,2012,0.4662034044032619,0.5337965955967381
1234,The Kid Who Would Be King,32140970,16790790,15350180,movies-2019.csv,2019,0.5224108046521309,0.4775891953478691
1235,Dilwale,31994323,4871263,27123060,movies-2015.csv,2015,0.15225397955756087,0.8477460204424391
1236,Suffragette,31972096,4702420,27269676,movies-2015.csv,2015,0.1470788777814254,0.8529211222185746
1237,Bad Times at the El Royale,31882724,17839115,14043609,movies-2018.csv,2018,0.5595229253309724,0.44047707466902764
1238,Self/less,31807156,12279691,19527465,movies-2015.csv,2015,0.38606692783221486,0.6139330721677851
1239,Spring Breakers,31724284,14124284,17600000,movies-2013.csv,2013,0.44521994570468476,0.5547800542953152
1240,Hunter Killer,31672678,15767460,15905218,movies-2018.csv,2018,0.49782528651350544,0.5021747134864946
1241,New World,31670607,457806,31212801,movies-2013.csv,2013,0.014455232891494628,0.9855447671085054
1242,Ae Dil Hai Mushkil,31668920,4264983,27403937,movies-2016.csv,2016,0.1346740905594507,0.8653259094405493
1243,Anna,31626978,7743794,23883184,movies-2019.csv,2019,0.2448477372703772,0.7551522627296228
1244,Super Troopers 2,31626386,30617396,1008990,movies-2018.csv,2018,0.9680965760678442,0.03190342393215589
1245,Bodyguard,31516209,1834384,29681825,movies-2011.csv,2011,0.058204462345074565,0.9417955376549254
1246,The Thing,31505287,16928670,14576617,movies-2011.csv,2011,0.5373279094394537,0.46267209056054626
1247,I Don't Know How She Does It,31410151,9662284,21747867,movies-2011.csv,2011,0.3076166045811114,0.6923833954188886
1248,What's in a Name?,31303580,8111,31295469,movies-2012.csv,2012,0.00025910774422605975,0.9997408922557739
1249,Tazza: The Hidden Card,31278476,251555,31026921,movies-2014.csv,2014,0.008042431479078457,0.9919575685209215
1250,Saving Mr. Wu,31222161,92696,31129465,movies-2015.csv,2015,0.0029689168536412326,0.9970310831463588
1251,My Dear Liar,31177968,90545,31087423,movies-2019.csv,2019,0.0029041340987969455,0.997095865901203
1252,Joyful Noise,31158113,30932113,226000,movies-2012.csv,2012,0.9927466724316714,0.007253327568328673
1253,Premium Rush,31083599,20275446,10808153,movies-2012.csv,2012,0.6522875938529512,0.3477124061470488
1254,The Wild Goose Lake,31042413,12573,31029840,movies-2019.csv,2019,0.00040502650357754084,0.9995949734964225
1255,The Strangers: Prey at Night,31039126,24586708,6452418,movies-2018.csv,2018,0.7921198554366512,0.20788014456334886
1256,This Is Not What I Expected,30996615,337670,30658945,movies-2017.csv,2017,0.010893770174581966,0.9891062298254181
1257,Playing for Keeps,30962335,13103272,17859063,movies-2012.csv,2012,0.42320038201253235,0.5767996179874677
1258,Billy Lynn's Long Halftime Walk,30930984,1738477,29192507,movies-2016.csv,2016,0.05620503376161586,0.9437949662383841
1259,African Cats,30857747,15428747,15429000,movies-2011.csv,2011,0.499995900543225,0.500004099456775
1260,Attack on Titan Part 1,30810658,449523,30361135,movies-2015.csv,2015,0.014589853939503662,0.9854101460604964
1261,Winter's Tale,30800231,12600231,18200000,movies-2014.csv,2014,0.40909534087585253,0.5909046591241475
1262,Norm of the North,30734502,17062499,13672003,movies-2016.csv,2016,0.5551578157993254,0.44484218420067456
1263,Carnage,30722632,2547047,28175585,movies-2011.csv,2011,0.08290458317503527,0.9170954168249648
1264,A Man Called Ove,30691696,3479315,27212381,movies-2015.csv,2015,0.11336339966354417,0.8866366003364559
1265,A Wedding Invitation,30665036,14350,30650686,movies-2013.csv,2013,0.0004679596658552757,0.9995320403341448
1266,When the Bough Breaks,30658387,29747603,910784,movies-2016.csv,2016,0.9702925010373181,0.02970749896268189
1267,Wild Tales,30642704,3106530,27536174,movies-2014.csv,2014,0.10137910805782675,0.8986208919421732
1268,A Dangerous Method,30519436,5704709,24814727,movies-2011.csv,2011,0.18692052500577008,0.81307947499423
1269,What's Your Number?,30426096,14011084,16415012,movies-2011.csv,2011,0.4604956219161341,0.5395043780838659
1270,Nocturnal Animals,30311857,10663357,19648500,movies-2016.csv,2016,0.3517883117487655,0.6482116882512345
1271,Far from the Madding Crowd,30229977,12236500,17993477,movies-2015.csv,2015,0.40478032781831097,0.595219672181689
1272,A Silent Voice: The Movie,30156463,310407,29846056,movies-2016.csv,2016,0.010293216415996797,0.9897067835840032
1273,When the Game Stands Tall,30138754,30127963,10791,movies-2014.csv,2014,0.9996419560012335,0.0003580439987665051
1274,The Rum Diary,30134958,13109815,17025143,movies-2011.csv,2011,0.4350367768888213,0.5649632231111787
1275,Reset 2017 Re-release,29949252,108970,29840282,movies-2017.csv,2017,0.0036384881999724067,0.9963615118000276
1276,Keeping Up with the Joneses,29918745,14904426,15014319,movies-2016.csv,2016,0.4981634757741342,0.5018365242258658
1277,The Bye Bye Man,29874280,22395806,7478474,movies-2017.csv,2017,0.7496684773658143,0.2503315226341857
1278,Draft Day,29824199,28842237,981962,movies-2014.csv,2014,0.9670749916871195,0.03292500831288042
1279,The Disaster Artist,29820616,21120616,8700000,movies-2017.csv,2017,0.7082555236283516,0.2917444763716484
1280,Like a Boss,29753143,22169514,7583629,movies-2020.csv,2020,0.7451150286878936,0.2548849713121064
1281,The Swindlers,29721916,241916,29480000,movies-2017.csv,2017,0.008139313764294335,0.9918606862357057
1282,The Raven,29699345,16008272,13691073,movies-2012.csv,2012,0.5390109445174632,0.4609890554825367
1283,Masterminds,29674699,17368022,12306677,movies-2016.csv,2016,0.5852804774868988,0.4147195225131011
1284,Amour,29652180,6739492,22912688,movies-2012.csv,2012,0.22728487416439533,0.7727151258356046
1285,Mr. Holmes,29355203,17737646,11617557,movies-2015.csv,2015,0.6042419805443008,0.3957580194556992
1286,Rowdy Rathore,29342463,777373,28565090,movies-2012.csv,2012,0.02649310659435781,0.9735068934056422
1287,Sword Art Online The Movie: Ordinal Scale,29322339,1522976,27799363,movies-2017.csv,2017,0.05193910349375607,0.9480608965062439
1288,Free Solo,29318861,17541090,11777771,movies-2018.csv,2018,0.5982868843370143,0.4017131156629857
1289,Big Eyes,29253166,14482031,14771135,movies-2014.csv,2014,0.495058586137309,0.504941413862691
1290,My Hero Academia: Heroes Rising,29187012,13304000,15883012,movies-2019.csv,2019,0.4558191842316713,0.5441808157683288
1291,Special ID,29139936,12666,29127270,movies-2013.csv,2013,0.0004346612154535961,0.9995653387845465
1292,Pad Man,29045020,1670192,27374828,movies-2018.csv,2018,0.057503558269197265,0.9424964417308027
1293,M.S. Dhoni: The Untold Story,28903047,1801550,27101497,movies-2016.csv,2016,0.06233079854867897,0.937669201451321
1294,Speak Bachchan,28775262,1216258,27559004,movies-2012.csv,2012,0.04226748656536993,0.9577325134346301
1295,Mirai,28756961,812794,27944167,movies-2018.csv,2018,0.028264252262260953,0.9717357477377391
1296,Twins 2,28733523,1431255,27302268,movies-2017.csv,2017,0.04981133013170713,0.9501886698682929
1297,The Suspect,28674130,218693,28455437,movies-2013.csv,2013,0.007626839942484741,0.9923731600575153
1298,The Fortress,28645448,252895,28392553,movies-2017.csv,2017,0.008828453302598025,0.9911715466974019
1299,Love & Mercy,28641776,12551031,16090745,movies-2015.csv,2015,0.43820714888629814,0.5617928511137019
1300,I Give It a Year,28328531,34657,28293874,movies-2013.csv,2013,0.0012233955936507969,0.9987766044063492
1301,The Master,28258060,16377274,11880786,movies-2012.csv,2012,0.5795611588339752,0.42043884116602487
1302,Fan,28240000,2300000,25940000,movies-2016.csv,2016,0.08144475920679886,0.9185552407932012
1303,Gully Boy,28141995,5566534,22575461,movies-2019.csv,2019,0.19780168392468267,0.8021983160753173
1304,Your Highness,28013733,21596445,6417288,movies-2011.csv,2011,0.7709234967007075,0.22907650329929252
1305,Mandela: Long Walk to Freedom,27985788,8323085,19662703,movies-2013.csv,2013,0.29740398948208996,0.70259601051791
1306,The Brothers Grimsby,27979040,6874837,21104203,movies-2016.csv,2016,0.24571382720779555,0.7542861727922044
1307,The 33,27972023,12227722,15744301,movies-2015.csv,2015,0.4371411392018375,0.5628588607981625
1308,The Divine Move,27926871,136707,27790164,movies-2014.csv,2014,0.004895177837860891,0.9951048221621391
1309,Monster Family,27890108,127259,27762849,movies-2017.csv,2017,0.004562872255639885,0.9954371277443601
1310,The Beguiled,27869129,10709995,17159134,movies-2017.csv,2017,0.3842960072415611,0.6157039927584389
1311,Dark Skies,27858103,17418667,10439436,movies-2013.csv,2013,0.6252639312877837,0.3747360687122163
1312,Default,27694043,203775,27490268,movies-2018.csv,2018,0.007358080580722721,0.9926419194192773
1313,Nebraska,27682872,17654912,10027960,movies-2013.csv,2013,0.6377557935462765,0.36224420645372346
1314,One Cut of the Dead,27590180,52406,27537774,movies-2018.csv,2018,0.0018994439325876091,0.9981005560674124
1315,The Women on the 6th Floor,27533970,719823,26814147,movies-2011.csv,2011,0.026143087974600104,0.9738569120253999
1316,The Happytime Murders,27506452,20706452,6800000,movies-2018.csv,2018,0.7527852737968532,0.2472147262031468
1317,The Incredible Burt Wonderstone,27437881,22537881,4900000,movies-2013.csv,2013,0.8214147805364416,0.17858521946355843
1318,Left Behind,27405896,14019924,13385972,movies-2014.csv,2014,0.5115659783573578,0.48843402164264216
1319,Irrational Man,27391084,4030360,23360724,movies-2015.csv,2015,0.14714131065422603,0.852858689345774
1320,Detective K: Secret of the Lost Island,27387870,185367,27202503,movies-2015.csv,2015,0.006768215271943382,0.9932317847280566
1321,Midnight Sun,27365467,9561064,17804403,movies-2018.csv,2018,0.34938428056060583,0.6506157194393942
1322,American Ultra,27262374,14440985,12821389,movies-2015.csv,2015,0.5297038695162791,0.4702961304837209
1323,Khumba,27187375,1029,27186346,movies-2013.csv,2013,3.7848449877930475e-05,0.999962151550122
1324,My Neighbor Totoro 2018 Re-release,27083857,1144649,25939208,movies-2018.csv,2018,0.042263145902741994,0.9577368540972581
1325,Hitchcock,27039669,6008677,21030992,movies-2012.csv,2012,0.22221710628188532,0.7777828937181147
1326,Total Dhamaal,26911995,2167632,24744363,movies-2019.csv,2019,0.08054519926895051,0.9194548007310495
1327,You're Next,26895481,18494006,8401475,movies-2013.csv,2013,0.6876250326216512,0.3123749673783488
1328,Chips,26800152,18600152,8200000,movies-2017.csv,2017,0.6940315860895118,0.3059684139104883
1329,A Cure for Wellness,26620002,8106986,18513016,movies-2017.csv,2017,0.3045449057441844,0.6954550942558156
1330,Missing Link,26565710,16649539,9916171,movies-2019.csv,2019,0.626730435587831,0.3732695644121689
1331,No Manches Frida 2,26493648,9270920,17222728,movies-2019.csv,2019,0.3499299152762957,0.6500700847237043
1332,A Hard Day,26488847,19004,26469843,movies-2014.csv,2014,0.0007174340204388662,0.9992825659795611
1333,The Way Way Back,26474920,21506546,4968374,movies-2013.csv,2013,0.8123365811870253,0.18766341881297469
1334,Only the Brave,26351322,18343983,8007339,movies-2017.csv,2017,0.6961314123063731,0.3038685876936269
1335,Twenty Two,26289378,46796,26242582,movies-2017.csv,2017,0.0017800345067121785,0.9982199654932878
1336,Aloha,26250020,21067116,5182904,movies-2015.csv,2015,0.8025561885286182,0.19744381147138174
1337,Apollo 18,26236153,17687709,8548444,movies-2011.csv,2011,0.6741731152429246,0.3258268847570755
1338,The Zookeeper's Wife,26152835,17571660,8581175,movies-2017.csv,2017,0.6718835644395722,0.32811643556042774
1339,Badrinath Ki Dulhania,26134309,1993259,24141050,movies-2017.csv,2017,0.0762698183449197,0.9237301816550803
1340,Top Five,26117471,25317471,800000,movies-2014.csv,2014,0.9693691628871723,0.030630837112827655
1341,Hichki,26055222,330279,25724943,movies-2018.csv,2018,0.012676115367583512,0.9873238846324165
1342,Iceman,26033917,7679,26026238,movies-2014.csv,2014,0.0002949613767302093,0.9997050386232698
1343,Agneepath,26001696,1986748,24014948,movies-2012.csv,2012,0.07640840043664844,0.9235915995633516
1344,The Light Between Oceans,25975621,12545979,13429642,movies-2016.csv,2016,0.48299053177592943,0.5170094682240706
1345,White Boy Rick,25957482,24011188,1946294,movies-2018.csv,2018,0.925019922964793,0.07498007703520704
1346,"Paul, Apostle of Christ",25915966,17560475,8355491,movies-2018.csv,2018,0.6775929170458087,0.32240708295419124
1347,Huevos: Little Rooster's Egg-cellent Adventure,25892561,9080818,16811743,movies-2015.csv,2015,0.3507114649647827,0.6492885350352172
1348,Rust and Bone,25807712,2062027,23745685,movies-2012.csv,2012,0.07989964395138942,0.9201003560486106
1349,Our Idiot Brother,25804448,24816118,988330,movies-2011.csv,2011,0.9616992388289026,0.038300761171097326
1350,Leap,25780959,83074,25697885,movies-2020.csv,2020,0.0032223006134100753,0.9967776993865899
1351,"The Gangster, the Cop, the Devil",25775371,216494,25558877,movies-2019.csv,2019,0.008399258346271718,0.9916007416537282
1352,A Beautiful Planet,25730120,15650615,10079505,movies-2016.csv,2016,0.6082604744944835,0.3917395255055165
1353,Fireworks,25672406,525280,25147126,movies-2017.csv,2017,0.020460879280266915,0.979539120719733
1354,Emma.,25645655,10055355,15590300,movies-2020.csv,2020,0.39208805546202663,0.6079119445379734
1355,Father Figures,25601244,17501244,8100000,movies-2017.csv,2017,0.6836091246191005,0.31639087538089944
1356,"Love, Rosie",25574387,20431,25553956,movies-2014.csv,2014,0.0007988852284123173,0.9992011147715877
1357,Mr. Donkey,25537759,356255,25181504,movies-2016.csv,2016,0.013950127730471574,0.9860498722695284
1358,Keys To The Heart,25375866,75134,25300732,movies-2018.csv,2018,0.0029608447648643795,0.9970391552351356
1359,A Haunted House 2,25358716,17329486,8029230,movies-2014.csv,2014,0.6833739531607199,0.31662604683928003
1360,And So It Goes,25312387,15160801,10151586,movies-2014.csv,2014,0.5989478985130877,0.40105210148691234
1361,Enough Said,25288872,17550872,7738000,movies-2013.csv,2013,0.6940156128751017,0.3059843871248983
1362,On the Other Side of the Tracks,25109572,9572,25100000,movies-2012.csv,2012,0.0003812092057961004,0.9996187907942039
1363,Born in China,25081168,13873211,11207957,movies-2016.csv,2016,0.5531325734112542,0.4468674265887458
1364,Race,25070261,19206207,5864054,movies-2016.csv,2016,0.7660952153629353,0.2339047846370646
1365,The Last Exorcism 2,25051865,15179302,9872563,movies-2013.csv,2013,0.6059150486400913,0.39408495135990873
1366,Free State of Jones,25035950,20810036,4225914,movies-2016.csv,2016,0.8312061655339622,0.16879383446603785
1367,Whiskey Tango Foxtrot,24972139,23083334,1888805,movies-2016.csv,2016,0.924363507667485,0.07563649233251504
1368,Housefull 2,24922847,1791780,23131067,movies-2012.csv,2012,0.07189307064317331,0.9281069293568267
1369,Booksmart,24863452,22680962,2182490,movies-2019.csv,2019,0.9122209578943423,0.08777904210565773
1370,Wild City,24817852,34866,24782986,movies-2015.csv,2015,0.0014048758127818636,0.9985951241872182
1371,Big Miracle,24719215,20157300,4561915,movies-2012.csv,2012,0.815450652458017,0.18454934754198302
1372,Super 30,24701637,2269878,22431759,movies-2019.csv,2019,0.09189180457959123,0.9081081954204088
1373,Scoob!,24700000,0,24700000,movies-2020.csv,2020,0.0,1.0
1374,Drug War,24676341,128195,24548146,movies-2013.csv,2013,0.005195057079167451,0.9948049429208325
1375,Ready,24663361,955148,23708213,movies-2011.csv,2011,0.03872740621199195,0.961272593788008
1376,The Death of Stalin,24646055,8047856,16598199,movies-2017.csv,2017,0.32653728963925466,0.6734627103607453
1377,The Snow Queen 3: Fire and Ice,24644317,0,24644317,movies-2016.csv,2016,0.0,1.0
1378,Sparkle,24637800,24397469,240331,movies-2012.csv,2012,0.9902454358749564,0.009754564125043632
1379,The Players,24629152,10854,24618298,movies-2012.csv,2012,0.00044069726801799754,0.999559302731982
1380,Honest Thief,24626787,12558569,12068218,movies-2020.csv,2020,0.5099556430158754,0.49004435698412463
1381,Capture the Flag,24604331,6690,24597641,movies-2015.csv,2015,0.00027190334904858825,0.9997280966509514
1382,God's Not Dead 2,24487848,20774575,3713273,movies-2016.csv,2016,0.8483626245964937,0.15163737540350627
1383,Stan & Ollie,24420923,5470235,18950688,movies-2018.csv,2018,0.22399788083357866,0.7760021191664214
1384,The Tale of The Princess Kaguya,24366656,703232,23663424,movies-2013.csv,2013,0.02886042303055454,0.9711395769694454
1385,The Great Beauty,24271739,2852400,21419339,movies-2013.csv,2013,0.11751939158541545,0.8824806084145845
1386,Jackie,24262468,13960394,10302074,movies-2016.csv,2016,0.5753905167438036,0.42460948325619635
1387,Trance,24261569,2328743,21932826,movies-2013.csv,2013,0.09598484747626998,0.90401515252373
1388,The Accidental Detective 2: In Action,24243825,179045,24064780,movies-2018.csv,2018,0.0073851795250955655,0.9926148204749045
1389,Jolly LLB 2,24214186,1654254,22559932,movies-2017.csv,2017,0.06831755566757437,0.9316824443324256
1390,The Gunman,24177137,10664749,13512388,movies-2015.csv,2015,0.44110884593159233,0.5588911540684077
1391,The Railway Man,24174885,4438438,19736447,movies-2013.csv,2013,0.18359706778336277,0.8164029322166372
1392,The Founder,24121245,12786053,11335192,movies-2016.csv,2016,0.5300743390318369,0.46992566096816313
1393,Bad Santa 2,24079268,17782178,6297090,movies-2016.csv,2016,0.7384849904905747,0.2615150095094253
1394,Kung Fu Jungle,24070765,129784,23940981,movies-2014.csv,2014,0.0053917688116684286,0.9946082311883315
1395,I Can Speak,24024444,63239,23961205,movies-2017.csv,2017,0.0026322773588433514,0.9973677226411567
1396,Spirits' Homecoming,23857217,125616,23731601,movies-2016.csv,2016,0.0052653249538703525,0.9947346750461297
1397,Silence,23834809,7100177,16734632,movies-2016.csv,2016,0.2978910802264033,0.7021089197735967
1398,Wanderlust,23812816,17450535,6362281,movies-2012.csv,2012,0.7328211413551425,0.26717885864485746
1399,The Dressmaker,23762417,2022115,21740302,movies-2015.csv,2015,0.08509719360618913,0.9149028063938108
1400,Pokémon the Movie: The Power of Us,23740788,789170,22951618,movies-2018.csv,2018,0.0332411038757433,0.9667588961242567
1401,The Peanut Butter Falcon,23725674,20457151,3268523,movies-2019.csv,2019,0.8622368747037492,0.13776312529625082
1402,Amy,23706049,8413144,15292905,movies-2015.csv,2015,0.3548943984718837,0.6451056015281164
1403,To the Arctic 3D,23695388,14560838,9134550,movies-2012.csv,2012,0.6145009315736886,0.3854990684263115
1404,What Now?,23591043,23591043,0,movies-2016.csv,2016,1.0,0.0
1405,The War with Grandpa,23576325,15449198,8127127,movies-2020.csv,2020,0.6552844007706884,0.3447155992293116
1406,No manches Frida,23540937,11528613,12012324,movies-2016.csv,2016,0.48972617360133114,0.5102738263986688
1407,Youth,23469540,2703296,20766244,movies-2015.csv,2015,0.11518316933352762,0.8848168306664723
1408,Wish Upon,23468586,14301505,9167081,movies-2017.csv,2017,0.6093892917110558,0.39061070828894423
1409,Only Cloud Knows,23410836,0,23410836,movies-2019.csv,2019,0.0,1.0
1410,Detroit,23355100,16790139,6564961,movies-2017.csv,2017,0.7189067484189748,0.2810932515810251
1411,Middle School: The Worst Years of My Life,23316139,20007149,3308990,movies-2016.csv,2016,0.8580815631610362,0.14191843683896377
1412,Warrior,23308615,13657115,9651500,movies-2011.csv,2011,0.5859256330760108,0.41407436692398925
1413,Triple 9,23177948,12639297,10538651,movies-2016.csv,2016,0.5453156163781194,0.4546843836218806
1414,Hoodwinked Too! Hood vs. Evil,23167844,10143779,13024065,movies-2011.csv,2011,0.4378387130023838,0.5621612869976161
1415,Rock Dog,23157646,9420546,13737100,movies-2016.csv,2016,0.40680067395451164,0.5931993260454884
1416,Dark Waters,23108017,11136084,11971933,movies-2019.csv,2019,0.48191430705629135,0.5180856929437087
1417,The Choice,23064015,18730891,4333124,movies-2016.csv,2016,0.8121262061267304,0.1878737938732697
1418,Padmaavat,22991060,11846060,11145000,movies-2018.csv,2018,0.5152463609768319,0.48475363902316815
1419,Young Adult,22939027,16311571,6627456,movies-2011.csv,2011,0.7110838223434673,0.28891617765653266
1420,A Separation,22926076,7099055,15827021,movies-2011.csv,2011,0.30964980662194436,0.6903501933780556
1421,Baggage Claim,22871096,21569509,1301587,movies-2013.csv,2013,0.9430903092707057,0.056909690729294304
1422,Won't You Be My Neighbor?,22844741,22835787,8954,movies-2018.csv,2018,0.9996080498351897,0.0003919501648103605
1423,Kon-Tiki,22842887,1517410,21325477,movies-2012.csv,2012,0.06642811830220935,0.9335718816977907
1424,Hunt for the Wilderpeople,22835917,5205468,17630449,movies-2016.csv,2016,0.22795090733601808,0.7720490926639819
1425,Sweet Sixteen,22819702,34327,22785375,movies-2016.csv,2016,0.001504270301163442,0.9984957296988366
1426,Captain Fantastic,22787526,5879835,16907691,movies-2016.csv,2016,0.2580286688427695,0.7419713311572305
1427,Extraordinary Mission,22757764,54174,22703590,movies-2017.csv,2017,0.0023804623336457836,0.9976195376663543
1428,Black and Blue,22741061,22055313,685748,movies-2019.csv,2019,0.9698453823240701,0.030154617675929897
1429,Fading Gigolo,22706304,3769873,18936431,movies-2014.csv,2014,0.1660275930420028,0.8339724069579972
1430,Live by Night,22678555,10378555,12300000,movies-2016.csv,2016,0.45763740238300016,0.5423625976169999
1431,The Farewell,22671661,17695781,4975880,movies-2019.csv,2019,0.7805242412543131,0.21947575874568695
1432,Julieta,22468044,1490948,20977096,movies-2016.csv,2016,0.06635860246668557,0.9336413975333144
1433,Late Night,22386555,15499454,6887101,movies-2019.csv,2019,0.6923554785450463,0.30764452145495363
1434,2 States,22386518,2238174,20148344,movies-2014.csv,2014,0.09997865679691678,0.9000213432030832
1435,Mojin: The Worm Valley,22381583,101516,22280067,movies-2018.csv,2018,0.004535693476194244,0.9954643065238058
1436,Solace,22354572,0,22354572,movies-2015.csv,2015,0.0,1.0
1437,Twenty,22271862,136125,22135737,movies-2015.csv,2015,0.006111972137758397,0.9938880278622416
1438,Fei chang xing yun,22259179,64432,22194747,movies-2013.csv,2013,0.0028946260776284696,0.9971053739223715
1439,Fifty Shades of Black,22227514,11686940,10540574,movies-2015.csv,2015,0.5257870943192298,0.47421290568077024
1440,Upside Down,22187813,105095,22082718,movies-2012.csv,2012,0.004736609236791386,0.9952633907632086
1441,Mr. Turner,22179785,3958500,18221285,movies-2014.csv,2014,0.17847332604892246,0.8215266739510775
1442,Sabotage,22126842,10508518,11618324,movies-2014.csv,2014,0.4749217262906293,0.5250782737093708
1443,The Glass Castle,22088533,17273059,4815474,movies-2017.csv,2017,0.7819921313923383,0.21800786860766172
1444,Gretel & Hansel,22051055,15347654,6703401,movies-2020.csv,2020,0.6960054292186927,0.3039945707813073
1445,Big Brother,22029250,85624,21943626,movies-2018.csv,2018,0.0038868322798097984,0.9961131677201902
1446,Bullet to the Head,21947209,9489829,12457380,movies-2013.csv,2013,0.4323934309824999,0.5676065690175002
1447,Leap! 2017 Re-release,21929861,21858070,71791,movies-2017.csv,2017,0.9967263358395204,0.003273664160479631
1448,Black or White,21833967,21571189,262778,movies-2015.csv,2015,0.9879647157110754,0.012035284288924683
1449,Master Z: The Ip Man Legacy,21832649,209454,21623195,movies-2018.csv,2018,0.009593613674639298,0.9904063863253607
1450,Welcome Back,21775694,1388365,20387329,movies-2015.csv,2015,0.0637575546386719,0.9362424453613281
1451,Diana,21766271,335359,21430912,movies-2013.csv,2013,0.015407278536594533,0.9845927214634055
1452,Legends of Oz: Dorothy's Return,21755418,8462347,13293071,movies-2014.csv,2014,0.38897652989246173,0.6110234701075383
1453,Proud Mary,21753365,20877013,876352,movies-2018.csv,2018,0.9597141867476595,0.0402858132523405
1454,It Follows,21729511,14674076,7055435,movies-2015.csv,2015,0.6753063149925463,0.3246936850074537
1455,The Star 2019 Re-release,21502695,43510,21459185,movies-2019.csv,2019,0.002023467290960505,0.9979765327090395
1456,Love & Friendship,21401949,14016568,7385381,movies-2016.csv,2016,0.6549201663829776,0.34507983361702244
1457,Shaft,21360215,21360215,0,movies-2019.csv,2019,1.0,0.0
1458,Bears,21316745,17780194,3536551,movies-2014.csv,2014,0.8340951679067324,0.16590483209326753
1459,Hotel Mumbai,21314816,9651611,11663205,movies-2019.csv,2019,0.4528123067072219,0.5471876932927782
1460,Love Live! The School Idol Movie,21292009,115840,21176169,movies-2015.csv,2015,0.005440538748598124,0.9945594612514018
1461,I'm So Excited!,21245677,1368119,19877558,movies-2013.csv,2013,0.06439517083875464,0.9356048291612453
1462,Unplanned,21238296,19005109,2233187,movies-2019.csv,2019,0.8948509334270508,0.10514906657294917
1463,The Prison,21205329,207481,20997848,movies-2017.csv,2017,0.009784380143312088,0.9902156198566879
1464,The Prodigy,21150265,14856291,6293974,movies-2018.csv,2018,0.7024163054221779,0.2975836945778221
1465,Beasts of the Southern Wild,21107746,12795746,8312000,movies-2012.csv,2012,0.6062109142302546,0.39378908576974536
1466,Gonjiam: Haunted Asylum,21041950,115252,20926698,movies-2018.csv,2018,0.005477249019221127,0.9945227509807789
1467,Yves Saint Laurent,21026290,723593,20302697,movies-2014.csv,2014,0.034413726815334514,0.9655862731846655
1468,My Hero Academia: Two Heroes,21022724,5754556,15268168,movies-2018.csv,2018,0.27373027396449673,0.7262697260355033
1469,The Infiltrator,21011110,15436808,5574302,movies-2016.csv,2016,0.7346974053250875,0.26530259467491246
1470,Before Midnight,20994648,8114627,12880021,movies-2013.csv,2013,0.38650931418330997,0.6134906858166901
1471,El nino,20918976,1237,20917739,movies-2014.csv,2014,5.9132913580473535e-05,0.9999408670864195
1472,SuperFly,20780685,20545116,235569,movies-2018.csv,2018,0.9886640406704591,0.01133595932954087
1473,The Photograph,20690779,20578185,112594,movies-2020.csv,2020,0.9945582522533347,0.005441747746665314
1474,Keanu,20651333,20591853,59480,movies-2016.csv,2016,0.9971197985137328,0.0028802014862672545
1475,The Front Line,20629645,11018,20618627,movies-2011.csv,2011,0.0005340857780150847,0.9994659142219849
1476,If Beale Street Could Talk,20596567,14915773,5680794,movies-2018.csv,2018,0.7241873366566379,0.275812663343362
1477,The Best Offer,20596350,100035,20496315,movies-2013.csv,2013,0.004856928533453743,0.9951430714665462
1478,Polisse,20590872,211440,20379432,movies-2011.csv,2011,0.010268627768653994,0.989731372231346
1479,The Man with the Iron Fists,20546518,15634090,4912428,movies-2012.csv,2012,0.7609118975779741,0.23908810242202597
1480,Race 2,20531909,1579940,18951969,movies-2013.csv,2013,0.07695046768422752,0.9230495323157725
1481,Cock and Bull,20490872,82778,20408094,movies-2016.csv,2016,0.004039749992094041,0.995960250007906
1482,The Sapphires,20423628,2450867,17972761,movies-2012.csv,2012,0.12000154918607017,0.8799984508139298
1483,That Demon Within,20415934,172343,20243591,movies-2014.csv,2014,0.00844159272850314,0.9915584072714969
1484,The Clan,20381995,201227,20180768,movies-2015.csv,2015,0.009872782325773311,0.9901272176742267
1485,Burn the Stage: The Movie,20347513,4201819,16145694,movies-2018.csv,2018,0.20650282911724888,0.7934971708827512
1486,Brahms: The Boy II,20311536,12611536,7700000,movies-2020.csv,2020,0.6209050856616654,0.37909491433833464
1487,Cold War 2018 Re-release,20296042,4580048,15715994,movies-2018.csv,2018,0.22566212663533117,0.7743378733646689
1488,Labor Day,20275812,13371528,6904284,movies-2014.csv,2014,0.6594817509651402,0.3405182490348599
1489,Singh Is Bliing,20224851,919095,19305756,movies-2015.csv,2015,0.045443845297055585,0.9545561547029444
1490,The Bling Ring,20045576,5845732,14199844,movies-2013.csv,2013,0.29162205166865746,0.7083779483313425
1491,The Company You Keep,20014680,5133027,14881653,movies-2012.csv,2012,0.25646310608013717,0.7435368939198628
1492,The Wife,19978189,9601092,10377097,movies-2018.csv,2018,0.48057869509593687,0.5194213049040631
1493,They Shall Not Grow Old,19866389,17956913,1909476,movies-2018.csv,2018,0.9038840928766673,0.09611590712333277
1494,The Rooftop,19833152,85755,19747397,movies-2013.csv,2013,0.0043238210446831645,0.9956761789553168
1495,Gone,19767535,11682205,8085330,movies-2012.csv,2012,0.590979350738471,0.4090206492615291
1496,It Comes at Night,19735344,13985117,5750227,movies-2017.csv,2017,0.7086330494163162,0.2913669505836838
1497,Brothers,19694450,613775,19080675,movies-2015.csv,2015,0.031164871321615988,0.9688351286783841
1498,Blackhat,19652057,8005980,11646077,movies-2015.csv,2015,0.4073863616414302,0.5926136383585698
1499,The Guard,19561904,5360274,14201630,movies-2011.csv,2011,0.27401596490811936,0.7259840350918806
1500,Puella Magi Madoka Magica the Movie Part III: The Rebellion Story,19544634,375627,19169007,movies-2013.csv,2013,0.019218932418995412,0.9807810675810046
1501,Margin Call,19504039,5354039,14150000,movies-2011.csv,2011,0.2745092439571106,0.7254907560428894
1502,In This Corner of the World,19496308,172147,19324161,movies-2016.csv,2016,0.008829723042947414,0.9911702769570526
1503,Blue Is the Warmest Colour,19465835,2199787,17266048,movies-2013.csv,2013,0.11300758482746823,0.8869924151725318
1504,The Edge of Seventeen,19370020,14431633,4938387,movies-2016.csv,2016,0.7450499792979047,0.2549500207020953
1505,The Lost City of Z,19263938,8580410,10683528,movies-2017.csv,2017,0.44541308220572556,0.5545869177942745
1506,Foxcatcher,19206513,12096300,7110213,movies-2014.csv,2014,0.6298019843581185,0.3701980156418815
1507,Everybody Knows,19176163,2660165,16515998,movies-2018.csv,2018,0.13872248582784782,0.8612775141721521
1508,My Annoying Brother,19162324,51996,19110328,movies-2016.csv,2016,0.0027134495794977685,0.9972865504205022
1509,Oolong Courtyard: KungFu School,19129015,37727,19091288,movies-2018.csv,2018,0.0019722395533695804,0.9980277604466304
1510,Shame,19123767,3909002,15214765,movies-2011.csv,2011,0.20440543957683652,0.7955945604231635
1511,Les Misérables,19082469,330181,18752288,movies-2013.csv,2013,0.01730284482579272,0.9826971551742073
1512,Always Miss You,19015465,91884,18923581,movies-2019.csv,2019,0.0048320669518205316,0.9951679330481795
1513,Memoir of a Murderer,19015346,91335,18924011,movies-2017.csv,2017,0.004803225773541013,0.995196774226459
1514,Jo Nesbø's Headhunters,18962444,1200010,17762434,movies-2011.csv,2011,0.0632835092354129,0.9367164907645871
1515,The Turning,18714343,15472775,3241568,movies-2020.csv,2020,0.8267869729650675,0.17321302703493252
1516,Pina,18705853,3524826,15181027,movies-2011.csv,2011,0.18843439002754914,0.8115656099724509
1517,Glee: The 3D Concert Movie,18663238,11862398,6800840,movies-2011.csv,2011,0.6356023536751768,0.3643976463248232
1518,The Drop,18658381,10724389,7933992,movies-2014.csv,2014,0.5747759679684963,0.4252240320315037
1519,Greta,18653107,10532219,8120888,movies-2019.csv,2019,0.56463617562479,0.43536382437521
1520,Peppa Celebrates Chinese New Year,18653040,131225,18521815,movies-2019.csv,2019,0.0070350462980833155,0.9929649537019167
1521,Gekijouban Fate/Stay Night: Heaven's Feel - III. Spring Song,18650994,0,18650994,movies-2020.csv,2020,0.0,1.0
1522,Admission,18637201,18007317,629884,movies-2013.csv,2013,0.9662028649044457,0.03379713509555431
1523,Detective K: Secret of the Living Dead,18603476,104013,18499463,movies-2018.csv,2018,0.005591051908793819,0.9944089480912062
1524,Battle of the Sexes,18598607,12638526,5960081,movies-2017.csv,2017,0.6795415377076358,0.32045846229236413
1525,Black Christmas,18529730,10429730,8100000,movies-2019.csv,2019,0.5628646504833044,0.4371353495166956
1526,Airpocalypse,18491089,105678,18385411,movies-2018.csv,2018,0.005715077137966293,0.9942849228620337
1527,Motherless Brooklyn,18477736,9277736,9200000,movies-2019.csv,2019,0.5021035044553077,0.4978964955446923
1528,Zero,18412196,1035388,17376808,movies-2018.csv,2018,0.05623381371782051,0.9437661862821795
1529,The Wasted Times,18345372,386540,17958832,movies-2016.csv,2016,0.021070164180917127,0.9789298358190829
1530,Fabricated City,18307490,104874,18202616,movies-2017.csv,2017,0.005728475066762292,0.9942715249332377
1531,Asura,18300843,175702,18125141,movies-2016.csv,2016,0.009600759921277943,0.990399240078722
1532,Chappaquiddick,18263470,17395520,867950,movies-2018.csv,2018,0.9524761723812616,0.04752382761873839
1533,The Case for Christ,18175663,14682684,3492979,movies-2017.csv,2017,0.8078210957146378,0.19217890428536225
1534,Sorry to Bother You,18170707,17493096,677611,movies-2018.csv,2018,0.9627086056695537,0.03729139433044625
1535,Hell Fest,18159691,11107431,7052260,movies-2018.csv,2018,0.6116530837446518,0.3883469162553482
1536,The Lighthouse,18113964,10867104,7246860,movies-2019.csv,2019,0.5999296454381824,0.4000703545618176
1537,Blinded by the Light,18096691,11901145,6195546,movies-2019.csv,2019,0.6576420517983095,0.3423579482016906
1538,Dead Man Down,18074539,10895295,7179244,movies-2013.csv,2013,0.6027979468798623,0.3972020531201377
1539,Kalank,17987034,2729336,15257698,movies-2019.csv,2019,0.15173908049542797,0.848260919504572
1540,Dope,17986781,17506470,480311,movies-2015.csv,2015,0.9732964447612944,0.02670355523870558
1541,Cantinflas,17966873,6382924,11583949,movies-2014.csv,2014,0.3552607067462435,0.6447392932537566
1542,We Have a Pope,17877523,548115,17329408,movies-2011.csv,2011,0.030659448739067487,0.9693405512609325
1543,Dil Dhadakne Do,17870077,3066100,14803977,movies-2015.csv,2015,0.17157732448494767,0.8284226755150523
1544,The Old Man & the Gun,17860397,11277120,6583277,movies-2018.csv,2018,0.6314036580485864,0.3685963419514135
1545,The Quiet Ones,17835162,8509867,9325295,movies-2014.csv,2014,0.4771398768343119,0.5228601231656881
1546,Unforgettable,17768012,11368012,6400000,movies-2017.csv,2017,0.6398021343074284,0.36019786569257156
1547,The Children Act,17696794,547750,17149044,movies-2018.csv,2018,0.03095193400567357,0.9690480659943265
1548,Regression,17671101,55039,17616062,movies-2015.csv,2015,0.0031146333213759574,0.996885366678624
1549,Before I Go to Sleep,17669776,3242457,14427319,movies-2014.csv,2014,0.18350300535784947,0.8164969946421505
1550,Neerja,17618280,1585687,16032593,movies-2015.csv,2015,0.09000237253579804,0.909997627464202
1551,Operation Finale,17612099,17612099,0,movies-2018.csv,2018,1.0,0.0
1552,Little Boy,17572289,6485961,11086328,movies-2015.csv,2015,0.3691016577293943,0.6308983422706057
1553,Toilet: A Love Story,17567417,1830715,15736702,movies-2017.csv,2017,0.10421082393615408,0.8957891760638459
1554,Loving Pablo,17535962,22017,17513945,movies-2018.csv,2018,0.0012555341988081407,0.9987444658011918
1555,Addicted,17534314,17390770,143544,movies-2014.csv,2014,0.9918135377295056,0.0081864622704943
1556,Machete Kills,17496820,8008161,9488659,movies-2013.csv,2013,0.45769236924195367,0.5423076307580463
1557,Fate/Stay Night: Heaven's Feel - I. Presage Flower,17422935,193833,17229102,movies-2017.csv,2017,0.011125163469874622,0.9888748365301254
1558,Stolen,17415418,304318,17111100,movies-2012.csv,2012,0.017474056608919753,0.9825259433910802
1559,Kapoor & Sons,17412627,2607036,14805591,movies-2016.csv,2016,0.14972100418851217,0.8502789958114878
1560,Billy and Buddy,17400053,894,17399159,movies-2013.csv,2013,5.1379153845106106e-05,0.9999486208461549
1561,Fruitvale Station,17385830,16101339,1284491,movies-2013.csv,2013,0.9261185114544431,0.07388148854555693
1562,Fate/stay night [Heaven's Feel] II. lost butterfly,17295864,420595,16875269,movies-2019.csv,2019,0.024317663459888447,0.9756823365401116
1563,While We're Young,17287309,7587485,9699824,movies-2015.csv,2015,0.4389049215236449,0.5610950784763551
1564,Legend of the Naga Pearls,17274695,13588,17261107,movies-2017.csv,2017,0.0007865840757246365,0.9992134159242754
1565,Digimon Adventure: Last Evolution Kizuna,17040162,0,17040162,movies-2020.csv,2020,0.0,1.0
1566,Melancholia,17039814,3030848,14008966,movies-2011.csv,2011,0.17786860819020678,0.8221313918097932
1567,Beyond Outrage,17027515,3878,17023637,movies-2012.csv,2012,0.0002277490285576022,0.9997722509714424
1568,Chinese Puzzle,16968297,338523,16629774,movies-2013.csv,2013,0.019950322651707476,0.9800496773482925
1569,Calvary,16887741,3600006,13287735,movies-2014.csv,2014,0.21317273873397277,0.7868272612660272
1570,The Cold Light of Day,16863583,3763583,13100000,movies-2012.csv,2012,0.2231781348008902,0.7768218651991098
1571,The Pyramid,16861137,2756333,14104804,movies-2014.csv,2014,0.16347254636505237,0.8365274536349476
1572,Monkey Kingdom,16839663,16432322,407341,movies-2015.csv,2015,0.9758106204381881,0.024189379561811896
1573,Hit and Run,16816647,13749300,3067347,movies-2012.csv,2012,0.8176005597310807,0.18239944026891924
1574,Hardcore Henry,16810562,9252038,7558524,movies-2016.csv,2016,0.5503705349053768,0.44962946509462326
1575,The Birth of a Nation,16779212,15861566,917646,movies-2016.csv,2016,0.9453105425928225,0.05468945740717741
1576,102 Not Out,16758596,1343797,15414799,movies-2018.csv,2018,0.08018553582889641,0.9198144641711036
1577,Baaghi 3,16726510,721439,16005071,movies-2020.csv,2020,0.043131472136147944,0.956868527863852
1578,Love Is All You Need,16722143,1631709,15090434,movies-2012.csv,2012,0.09757774467064419,0.9024222553293558
1579,Delhi Belly,16706074,1532594,15173480,movies-2011.csv,2011,0.09173872927894369,0.9082612707210563
1580,Pride,16699029,1446634,15252395,movies-2014.csv,2014,0.08662982739894637,0.9133701726010536
1581,Mai wei,16653488,70177,16583311,movies-2011.csv,2011,0.004213952056169854,0.9957860479438302
1582,Beautiful Boy,16636604,7649973,8986631,movies-2018.csv,2018,0.45982779899070747,0.5401722010092925
1583,Nothing to Lose 2,16610713,1150551,15460162,movies-2019.csv,2019,0.06926559985715243,0.9307344001428476
1584,Belle,16607575,10726630,5880945,movies-2014.csv,2014,0.6458877951778029,0.3541122048221971
1585,Upgrade,16593554,11977130,4616424,movies-2018.csv,2018,0.7217941376512832,0.27820586234871686
1586,Tazza: One-Eyed Jack,16572611,97655,16474956,movies-2019.csv,2019,0.005892553683906537,0.9941074463160935
1587,Battle of the Year,16549477,8888355,7661122,movies-2013.csv,2013,0.5370776973798024,0.4629223026201976
1588,Silent House,16527747,12754783,3772964,movies-2012.csv,2012,0.7717194001094039,0.2282805998905961
1589,Pride and Prejudice and Zombies,16457494,10938134,5519360,movies-2016.csv,2016,0.6646293779599738,0.33537062204002627
1590,Poms,16418218,13631124,2787094,movies-2019.csv,2019,0.8302438181780751,0.1697561818219249
1591,Forever My Girl,16376066,16376066,0,movies-2018.csv,2018,1.0,0.0
1592,Before I Fall,16373843,12241122,4132721,movies-2017.csv,2017,0.7476022580648904,0.25239774193510955
1593,The Single Moms Club,16365451,15973881,391570,movies-2014.csv,2014,0.9760733755519478,0.02392662444805218
1594,Little Q,16360233,1652,16358581,movies-2019.csv,2019,0.0001009765569964682,0.9998990234430035
1595,Playmobil: The Movie,16349303,1115008,15234295,movies-2019.csv,2019,0.068199115277269,0.931800884722731
1596,Macbeth,16322067,1110707,15211360,movies-2015.csv,2015,0.06804940820301743,0.9319505917969826
1597,Gangnam 1970,16191434,18022,16173412,movies-2015.csv,2015,0.0011130576822287637,0.9988869423177712
1598,In the House,16190771,389757,15801014,movies-2012.csv,2012,0.024072788133437252,0.9759272118665627
1599,Scouts Guide to the Zombie Apocalypse,16137046,3703046,12434000,movies-2015.csv,2015,0.22947483696830262,0.7705251630316974
1600,The Space Between Us,16080475,7885294,8195181,movies-2017.csv,2017,0.4903644948299102,0.5096355051700898
1601,Unfriended: Dark Web,16024987,8866745,7158242,movies-2018.csv,2018,0.5533074691417846,0.44669253085821536
1602,The Kitchen,15980032,12180032,3800000,movies-2019.csv,2019,0.762203229630579,0.23779677036942104
1603,The Words,15950164,11494838,4455326,movies-2012.csv,2012,0.7206720883873043,0.27932791161269566
1604,Wonder Wheel,15889124,1404061,14485063,movies-2017.csv,2017,0.08836616795236792,0.911633832047632
1605,The Hunt,15843274,613308,15229966,movies-2012.csv,2012,0.038710938155838245,0.9612890618441617
1606,"I, Daniel Blake",15793051,260354,15532697,movies-2016.csv,2016,0.01648535169043651,0.9835146483095635
1607,Finding Your Feet,15775555,1418682,14356873,movies-2018.csv,2018,0.08992913403046676,0.9100708659695332
1608,I Still Believe,15756972,9868521,5888451,movies-2020.csv,2020,0.6262955217537989,0.3737044782462011
1609,The Brand New Testament,15709652,127910,15581742,movies-2015.csv,2015,0.008142128164264873,0.9918578718357351
1610,Feng Shui,15702302,64147,15638155,movies-2018.csv,2018,0.004085197189558576,0.9959148028104414
1611,Judy Moody and the Not Bummer Summer,15691640,15013650,677990,movies-2011.csv,2011,0.956792916482917,0.04320708351708298
1612,Out of the Furnace,15660668,11330849,4329819,movies-2013.csv,2013,0.723522713079672,0.276477286920328
1613,The Divine Move 2: The Wrathful,15642991,67578,15575413,movies-2019.csv,2019,0.004320017827792652,0.9956799821722073
1614,Vampire Academy,15642346,7791979,7850367,movies-2014.csv,2014,0.4981336559106927,0.5018663440893073
1615,Tully,15636462,9369755,6266707,movies-2018.csv,2018,0.5992247479001324,0.4007752520998676
1616,The Conspirator,15623183,11538204,4084979,movies-2011.csv,2011,0.7385309382857513,0.2614690617142486
1617,Paranoia,15500644,7388654,8111990,movies-2013.csv,2013,0.47666755007082284,0.5233324499291772
1618,Chronicles of Evil,15460494,105057,15355437,movies-2015.csv,2015,0.006795190373606432,0.9932048096263936
1619,Our Little Sister,15407615,64441,15343174,movies-2015.csv,2015,0.004182412398025262,0.9958175876019747
1620,Anonymous,15395087,4463292,10931795,movies-2011.csv,2011,0.2899166467847827,0.7100833532152173
1621,Miss Bala,15383580,15006824,376756,movies-2019.csv,2019,0.9755092117699521,0.024490788230047883
1622,When Harry Met Sejal,15360368,1664648,13695720,movies-2017.csv,2017,0.10837292439868629,0.8916270756013137
1623,Apollo 11,15342353,9039891,6302462,movies-2019.csv,2019,0.5892115114285273,0.4107884885714727
1624,The Dead Don't Die,15322395,6563605,8758790,movies-2019.csv,2019,0.42836677947540186,0.5716332205245982
1625,The Negotiation,15229193,110986,15118207,movies-2018.csv,2018,0.0072877138007247004,0.9927122861992753
1626,Attack on Titan Part 2,15186410,305934,14880476,movies-2015.csv,2015,0.020145248284485932,0.9798547517155141
1627,Spectacle,15159762,2065487,13094275,movies-2015.csv,2015,0.13624798331266677,0.8637520166873333
1628,Irreplaceable,15130912,8494,15122418,movies-2016.csv,2016,0.0005613673518159382,0.9994386326481841
1629,Three,15121228,119550,15001678,movies-2016.csv,2016,0.007906103922247585,0.9920938960777524
1630,War of the Buttons,15082409,47771,15034638,movies-2011.csv,2011,0.003167332221265184,0.9968326677787348
1631,Journey to the South Pacific,14994876,7653913,7340963,movies-2013.csv,2013,0.510435231341693,0.489564768658307
1632,Gold,14880939,7227038,7653901,movies-2017.csv,2017,0.4856573903031254,0.5143426096968746
1633,School of Life,14880497,6300,14874197,movies-2017.csv,2017,0.00042337295588984697,0.9995766270441101
1634,Emperor,14858240,3346265,11511975,movies-2013.csv,2013,0.22521274390506546,0.7747872560949345
1635,The Take,14857808,50269,14807539,movies-2016.csv,2016,0.0033833389151347224,0.9966166610848652
1636,Dabangg 3,14784628,202000,14582628,movies-2019.csv,2019,0.013662839538471985,0.986337160461528
1637,Seondal: The Man Who Sells the River,14777982,97477,14680505,movies-2016.csv,2016,0.006596096814842514,0.9934039031851575
1638,A Royal Affair,14758997,1546761,13212236,movies-2012.csv,2012,0.10480122734627563,0.8951987726537244
1639,Made in India,14751915,790628,13961287,movies-2018.csv,2018,0.053594940046766806,0.9464050599532332
1640,Sword Master,14714624,75526,14639098,movies-2016.csv,2016,0.005132716948798691,0.9948672830512013
1641,Inherent Vice,14710975,8110975,6600000,movies-2014.csv,2014,0.5513553656368799,0.4486446343631201
1642,The Way Back,14690514,13590514,1100000,movies-2020.csv,2020,0.9251217486331655,0.0748782513668344
1643,"Hello, My Name Is Doris",14659448,14444999,214449,movies-2016.csv,2016,0.985371277281382,0.014628722718618054
1644,Beyond the Lights,14618727,14618727,0,movies-2014.csv,2014,1.0,0.0
1645,Megan Leavey,14510490,13406883,1103607,movies-2017.csv,2017,0.9239441948548947,0.07605580514510536
1646,A United Kingdom,14459330,3902185,10557145,movies-2016.csv,2016,0.269873154565253,0.7301268454347469
1647,Serenity,14454622,8547045,5907577,movies-2019.csv,2019,0.5913018687033117,0.40869813129668836
1648,America: Imagine the World Without Her,14444502,14444502,0,movies-2014.csv,2014,1.0,0.0
1649,RBG,14441292,14017361,423931,movies-2018.csv,2018,0.9706445240495103,0.02935547595048975
1650,Unfinished Business,14431253,10219501,4211752,movies-2015.csv,2015,0.7081506366772171,0.29184936332278283
1651,45 Years,14430249,4247285,10182964,movies-2015.csv,2015,0.2943320659262359,0.705667934073764
1652,Do You Believe?,14410698,12985600,1425098,movies-2015.csv,2015,0.9011083293814082,0.09889167061859183
1653,Woodlawn,14401617,14394097,7520,movies-2015.csv,2015,0.9994778364123973,0.0005221635876026977
1654,Eighth Grade,14347433,13539709,807724,movies-2018.csv,2018,0.9437025424687469,0.056297457531253155
1655,Tall Tales from the Magical Garden of Antoon Krings,14340726,220,14340506,movies-2017.csv,2017,1.5340924859731648e-05,0.9999846590751402
1656,The Other Side of the Door,14332467,3000342,11332125,movies-2016.csv,2016,0.20933883887540086,0.7906611611245992
1657,Beginners,14311701,5790894,8520807,movies-2011.csv,2011,0.4046265360071455,0.5953734639928545
1658,The Beauty Inside,14301869,108083,14193786,movies-2015.csv,2015,0.007557264019129248,0.9924427359808707
1659,Unsane,14293601,7732899,6560702,movies-2018.csv,2018,0.5410042577794077,0.45899574222059225
1660,Colette,14273033,5137622,9135411,movies-2018.csv,2018,0.35995306673781247,0.6400469332621875
1661,La Belle Époque,14233465,0,14233465,movies-2019.csv,2019,0.0,1.0
1662,Ya veremos,14134723,4165949,9968774,movies-2018.csv,2018,0.2947315628328903,0.7052684371671096
1663,Shaandaar,14120808,521794,13599014,movies-2015.csv,2015,0.03695213475036273,0.9630478652496373
1664,Red Lights,14107313,52624,14054689,movies-2012.csv,2012,0.0037302638709440982,0.9962697361290559
1665,Seeking Justice,14089528,411746,13677782,movies-2011.csv,2011,0.02922354815576505,0.970776451844235
1666,Island of Lemurs: Madagascar,14066534,11272213,2794321,movies-2014.csv,2014,0.8013497141513325,0.19865028584866748
1667,The Personal History of David Copperfield,14056678,1876298,12180380,movies-2020.csv,2020,0.1334808978337556,0.8665191021662444
1668,Kedarnath,13999297,901131,13098166,movies-2018.csv,2018,0.06436973228012807,0.9356302677198719
1669,The Quake,13837294,6235,13831059,movies-2018.csv,2018,0.0004505938805665327,0.9995494061194334
1670,Pulling Strings,13725819,5842961,7882858,movies-2013.csv,2013,0.4256912465478381,0.5743087534521619
1671,Phantom,13676590,489984,13186606,movies-2015.csv,2015,0.03582647428927825,0.9641735257107218
1672,The Bride of Humpty Sharma,13669988,380011,13289977,movies-2014.csv,2014,0.027798927109519044,0.972201072890481
1673,All Is Lost,13627519,6263670,7363849,movies-2013.csv,2013,0.45963392162579264,0.5403660783742074
1674,Sing Street,13624522,3237118,10387404,movies-2016.csv,2016,0.23759497764398635,0.7624050223560137
1675,Do It Like An Hombre,13610252,2534252,11076000,movies-2017.csv,2017,0.18620169560416663,0.8137983043958333
1676,Love Forecast,13608637,32211,13576426,movies-2015.csv,2015,0.0023669526933520232,0.9976330473066479
1677,Strange Magic,13603453,12429583,1173870,movies-2015.csv,2015,0.9137079387123255,0.08629206128767454
1678,The Two Faces of January,13551951,507463,13044488,movies-2014.csv,2014,0.03744575227581623,0.9625542477241837
1679,Nymphomaniac: Vol. I,13545832,785896,12759936,movies-2013.csv,2013,0.05801755108139537,0.9419824489186046
1680,Phantom of the Theatre,13526843,43955,13482888,movies-2016.csv,2016,0.0032494647864250363,0.9967505352135749
1681,Three Identical Strangers,13448497,12320845,1127652,movies-2018.csv,2018,0.9161503326356841,0.08384966736431587
1682,The Third Murder,13411936,89315,13322621,movies-2017.csv,2017,0.006659366701421778,0.9933406332985782
1683,The Witches,13400000,0,13400000,movies-2020.csv,2020,0.0,1.0
1684,Our President,13392049,507268,12884781,movies-2017.csv,2017,0.03787829629356942,0.9621217037064306
1685,Ratchet & Clank,13385737,8821329,4564408,movies-2016.csv,2016,0.6590095860989947,0.3409904139010052
1686,Hotel Artemis,13313581,6708147,6605434,movies-2018.csv,2018,0.5038574520258674,0.4961425479741326
1687,Paris Can Wait,13203541,5617731,7585810,movies-2017.csv,2017,0.42547154585273755,0.5745284541472625
1688,The Well Digger's Daughter,13194167,386368,12807799,movies-2011.csv,2011,0.029283243117962657,0.9707167568820373
1689,Mommy,13156856,3494070,9662786,movies-2014.csv,2014,0.2655702851805933,0.7344297148194067
1690,The Sisters Brothers,13143056,3143056,10000000,movies-2018.csv,2018,0.23914194689576002,0.76085805310424
1691,Hillary's America: The Secret History of the Democratic Party,13099931,13099931,0,movies-2016.csv,2016,1.0,0.0
1692,The Angels' Share,13090471,346669,12743802,movies-2012.csv,2012,0.026482545967979304,0.9735174540320207
1693,Shut In,13082071,6900335,6181736,movies-2016.csv,2016,0.5274650321038619,0.47253496789613814
1694,Hot Tub Time Machine 2,13081651,12314651,767000,movies-2015.csv,2015,0.94136825695778,0.05863174304221998
1695,Welcome to Marwen,13061491,10763520,2297971,movies-2018.csv,2018,0.8240651852074162,0.1759348147925838
1696,"Roman J. Israel, Esq.",13025860,11962778,1063082,movies-2017.csv,2017,0.9183868090091556,0.08161319099084437
1697,Friends with Kids,13019073,7251073,5768000,movies-2012.csv,2012,0.5569577035169861,0.4430422964830138
1698,The Vatican Tapes,13015764,1784763,11231001,movies-2015.csv,2015,0.13712318385613015,0.8628768161438698
1699,Pyaar Ka Punchnama 2,12983721,222856,12760865,movies-2015.csv,2015,0.017164262848839713,0.9828357371511602
1700,The Wave,12975143,177404,12797739,movies-2015.csv,2015,0.013672604610215086,0.9863273953897849
1701,Le Havre,12959706,611709,12347997,movies-2011.csv,2011,0.04720083927829844,0.9527991607217016
1702,Loving,12957265,7751969,5205296,movies-2016.csv,2016,0.5982720118790501,0.4017279881209499
1703,Child 44,12951093,1224330,11726763,movies-2015.csv,2015,0.09453487825313277,0.9054651217468672
1704,Take Point,12908032,112386,12795646,movies-2018.csv,2018,0.008706671938836221,0.9912933280611638
1705,Mubarakan,12899968,758868,12141100,movies-2017.csv,2017,0.05882712267193221,0.9411728773280678
1706,Earth: One Amazing Day,12851540,81345,12770195,movies-2017.csv,2017,0.006329591628707532,0.9936704083712925
1707,Suburbicon,12751667,5775178,6976489,movies-2017.csv,2017,0.4528959233330042,0.5471040766669958
1708,Elle,12748594,2341534,10407060,movies-2016.csv,2016,0.18366997960716294,0.8163300203928371
1709,Populaire,12698385,179091,12519294,movies-2012.csv,2012,0.014103447013143797,0.9858965529868562
1710,The Past,12673462,1331747,11341715,movies-2013.csv,2013,0.10508154756766541,0.8949184524323346
1711,Redemption,12671109,36895,12634214,movies-2013.csv,2013,0.0029117419793326695,0.9970882580206674
1712,The Green Inferno,12666449,7192291,5474158,movies-2015.csv,2015,0.5678222049447323,0.43217779505526766
1713,Luis and the Aliens,12627729,169710,12458019,movies-2018.csv,2018,0.013439471182823135,0.9865605288171768
1714,Their Finest,12597262,3603484,8993778,movies-2017.csv,2017,0.2860529534116223,0.7139470465883777
1715,People Like Us,12558931,12434778,124153,movies-2012.csv,2012,0.9901143656255457,0.009885634374454322
1716,The Promise,12448676,8224288,4224388,movies-2017.csv,2017,0.6606556392021128,0.33934436079788727
1717,Can You Ever Forgive Me?,12442161,8803865,3638296,movies-2018.csv,2018,0.707583272712835,0.292416727287165
1718,Rampant,12359573,167937,12191636,movies-2018.csv,2018,0.013587605332320138,0.9864123946676798
1719,Marrowbone,12294931,1377,12293554,movies-2017.csv,2017,0.00011199737517843735,0.9998880026248216
1720,The Beatles: Eight Days a Week - The Touring Years,12283800,2930414,9353386,movies-2016.csv,2016,0.23855924062586495,0.761440759374135
1721,The Man Who Knew Infinity,12252684,3866794,8385890,movies-2016.csv,2016,0.3155875071943421,0.684412492805658
1722,The Guillotines,12217440,5290,12212150,movies-2012.csv,2012,0.0004329875980565487,0.9995670124019435
1723,The Current War: Director's Cut,12217160,5979540,6237620,movies-2019.csv,2019,0.48943780714994317,0.5105621928500568
1724,I Married an Anti-Fan,12194083,89408,12104675,movies-2016.csv,2016,0.007332080649278835,0.9926679193507212
1725,Little Women,12165890,1379497,10786393,movies-2018.csv,2018,0.11339055342436928,0.8866094465756307
1726,Miss & Mrs. Cops,12147170,104578,12042592,movies-2019.csv,2019,0.008609248080005466,0.9913907519199945
1727,Bachelorette,12128575,447954,11680621,movies-2012.csv,2012,0.03693377004305947,0.9630662299569406
1728,Barney's Version,12104765,4439201,7665564,movies-2011.csv,2011,0.3667316961543657,0.6332683038456344
1729,Stoker,12077441,1714221,10363220,movies-2012.csv,2012,0.14193577927642123,0.8580642207235788
1730,The Connection,12062441,190980,11871461,movies-2014.csv,2014,0.01583261630046522,0.9841673836995348
1731,The Bookshop,12055868,1588150,10467718,movies-2017.csv,2017,0.13173253058178805,0.868267469418212
1732,A Most Violent Year,12007070,5749134,6257936,movies-2014.csv,2014,0.47881239969451334,0.5211876003054867
1733,The Assassin,11991669,632542,11359127,movies-2015.csv,2015,0.052748453947486375,0.9472515460525136
1734,Mere Brother Ki Dulhan,11983381,496172,11487209,movies-2011.csv,2011,0.041405009153927426,0.9585949908460726
1735,This Must Be the Place,11928909,143979,11784930,movies-2011.csv,2011,0.012069754241565594,0.9879302457584344
1736,The Warring States,11868961,68961,11800000,movies-2011.csv,2011,0.005810196865589161,0.9941898031344109
1737,Viceroy's House,11868221,1105717,10762504,movies-2017.csv,2017,0.09316619567498785,0.9068338043250121
1738,Ballon,11859396,34222,11825174,movies-2018.csv,2018,0.0028856444291092058,0.9971143555708908
1739,Boy Erased,11853081,6788692,5064389,movies-2018.csv,2018,0.5727364893566491,0.4272635106433509
1740,Unstoppable,11845347,101417,11743930,movies-2018.csv,2018,0.008561758469380424,0.9914382415306195
1741,Wo zhi nv ren xin,11838177,123526,11714651,movies-2011.csv,2011,0.010434545791974559,0.9895654542080254
1742,Last Letter,11834622,180946,11653676,movies-2018.csv,2018,0.015289546214488303,0.9847104537855117
1743,Ash Is Purest White,11813509,422814,11390695,movies-2018.csv,2018,0.03579072060638376,0.9642092793936162
1744,Getaway,11806432,10501938,1304494,movies-2013.csv,2013,0.8895098874918349,0.11049011250816504
1745,The Divine Fury,11799556,102982,11696574,movies-2019.csv,2019,0.0087276165306559,0.9912723834693441
1746,Win Win,11789613,10179275,1610338,movies-2011.csv,2011,0.8634104444310429,0.1365895555689572
1747,Toni Erdmann,11784207,1479387,10304820,movies-2016.csv,2016,0.12553980085380373,0.8744601991461962
1748,The Interview,11782625,6105175,5677450,movies-2014.csv,2014,0.5181506667656826,0.4818493332343175
1749,C'est Si Bon,11750035,164167,11585868,movies-2015.csv,2015,0.013971617956882681,0.9860283820431173
1750,Seeking a Friend for the End of the World,11681781,7078738,4603043,movies-2012.csv,2012,0.6059639364922181,0.3940360635077819
1751,Bring the Soul: The Movie,11641119,4809800,6831319,movies-2019.csv,2019,0.41317333840501075,0.5868266615949893
1752,Back to Burgundy,11625884,257610,11368274,movies-2017.csv,2017,0.02215831501501305,0.9778416849849869
1753,The Lunchbox 2013 Re-release,11621581,4235151,7386430,movies-2013.csv,2013,0.36442124354681177,0.6355787564531883
1754,Delicacy,11597420,498584,11098836,movies-2011.csv,2011,0.042990941088621434,0.9570090589113786
1755,Haute Cuisine,11509942,217883,11292059,movies-2012.csv,2012,0.01892998244474212,0.9810700175552579
1756,Fists of Legend,11478881,134213,11344668,movies-2013.csv,2013,0.011692167555356658,0.9883078324446434
1757,Double Dhamaal,11445869,543646,10902223,movies-2011.csv,2011,0.0474971363030627,0.9525028636969373
1758,Trumbo,11430025,7857741,3572284,movies-2015.csv,2015,0.6874649005579603,0.3125350994420397
1759,Seasons,11425100,150092,11275008,movies-2016.csv,2016,0.013137040376014214,0.9868629596239857
1760,Fun Size,11417362,9409538,2007824,movies-2012.csv,2012,0.8241429149745799,0.17585708502542005
1761,The King's Case Note,11383493,90959,11292534,movies-2017.csv,2017,0.007990429651074587,0.9920095703489255
1762,King of Thieves,11353515,7518,11345997,movies-2018.csv,2018,0.0006621737849467764,0.9993378262150532
1763,Bajirao Mastani,11350917,6557047,4793870,movies-2015.csv,2015,0.577666720671114,0.4223332793288859
1764,The Apparition,11350665,4936819,6413846,movies-2012.csv,2012,0.4349365433655209,0.5650634566344791
1765,Snow Flower and the Secret Fan,11348205,1348205,10000000,movies-2011.csv,2011,0.11880337022463024,0.8811966297753697
1766,Tomorrow,11277905,62510,11215395,movies-2015.csv,2015,0.00554269609470908,0.994457303905291
1767,At Eternity's Gate,11235662,2294915,8940747,movies-2018.csv,2018,0.20425276232054684,0.7957472376794531
1768,Ida,11156836,3827060,7329776,movies-2013.csv,2013,0.343023774840824,0.656976225159176
1769,Gloria Bell,11145006,5611123,5533883,movies-2019.csv,2019,0.5034652291797779,0.49653477082022207
1770,Bicycling with Molière,11123929,59874,11064055,movies-2013.csv,2013,0.0053824507509891515,0.9946175492490108
1771,We Are Your Friends,11122090,3591417,7530673,movies-2015.csv,2015,0.32290846414657676,0.6770915358534232
1772,The Belko Experiment,11084630,10166820,917810,movies-2017.csv,2017,0.9171997621932352,0.08280023780676486
1773,Action Jackson,11060963,256872,10804091,movies-2014.csv,2014,0.023223294391274973,0.976776705608725
1774,Promised Land,11039031,7597898,3441133,movies-2012.csv,2012,0.6882758097155448,0.3117241902844552
1775,"Where'd You Go, Bernadette",11025353,9198356,1826997,movies-2019.csv,2019,0.8342912920792649,0.16570870792073505
1776,La boda de Valentina,11021794,2783739,8238055,movies-2018.csv,2018,0.2525667781488204,0.7474332218511796
1777,The Loft,11016443,6002684,5013759,movies-2014.csv,2014,0.5448840428802655,0.45511595711973457
1778,Gringo,11001627,4969853,6031774,movies-2018.csv,2018,0.4517380020246096,0.5482619979753903
1779,[REC] 3: Genesis,10998667,9600,10989067,movies-2012.csv,2012,0.0008728330442225408,0.9991271669557774
1780,Hyde Park on Hudson,10980481,6376145,4604336,movies-2012.csv,2012,0.5806799356057353,0.41932006439426467
1781,Justin Bieber's Believe,10980157,6206566,4773591,movies-2013.csv,2013,0.5652529376401448,0.43474706235985516
1782,Friend Request,10975390,3759078,7216312,movies-2016.csv,2016,0.3425006309570776,0.6574993690429224
1783,The Florida Project,10971298,5904366,5066932,movies-2017.csv,2017,0.538164764096281,0.46183523590371894
1784,One Chance,10900434,101196,10799238,movies-2013.csv,2013,0.009283667053990695,0.9907163329460094
1785,A Bag of Marbles,10898998,411318,10487680,movies-2017.csv,2017,0.037739065554466565,0.9622609344455334
1786,The Darkness,10898293,10753574,144719,movies-2016.csv,2016,0.9867209479502891,0.013279052049710905
1787,The Hunt,10891670,5812500,5079170,movies-2020.csv,2020,0.5336647180827183,0.46633528191728174
1788,Only You,10857889,61565,10796324,movies-2015.csv,2015,0.005670070858156682,0.9943299291418434
1789,Danny Collins,10835752,5637066,5198686,movies-2015.csv,2015,0.5202284068516887,0.47977159314831125
1790,Flying Monsters 3D with David Attenborough,10813862,5705874,5107988,movies-2011.csv,2011,0.5276444252756324,0.4723555747243677
1791,Golden Slumber,10733326,94450,10638876,movies-2018.csv,2018,0.008799695453208073,0.991200304546792
1792,Our Kind of Traitor,10711027,3153157,7557870,movies-2016.csv,2016,0.2943841893032293,0.7056158106967707
1793,Prom,10702246,10130219,572027,movies-2011.csv,2011,0.9465507520570916,0.05344924794290843
1794,Impractical Jokers: The Movie,10691091,10691091,0,movies-2020.csv,2020,1.0,0.0
1795,The Sessions,10656155,6002451,4653704,movies-2012.csv,2012,0.563284880897472,0.4367151191025281
1796,Red Joan,10647493,1579730,9067763,movies-2018.csv,2018,0.14836638070576802,0.851633619294232
1797,Only God Forgives,10635126,779188,9855938,movies-2013.csv,2013,0.07326551655335348,0.9267344834466466
1798,My Old Lady,10606667,4013786,6592881,movies-2014.csv,2014,0.37842104404710736,0.6215789559528927
1799,The Phone,10551318,40516,10510802,movies-2015.csv,2015,0.0038398994324690054,0.996160100567531
1800,Moms' Night Out,10536956,10429707,107249,movies-2014.csv,2014,0.9898216334964292,0.01017836650357086
1801,The Leisure Seeker,10472180,3226443,7245737,movies-2017.csv,2017,0.308096594978314,0.691903405021686
1802,Mood Indigo,10435322,303187,10132135,movies-2013.csv,2013,0.029053918987837653,0.9709460810121624
1803,Furious,10433259,9996,10423263,movies-2017.csv,2017,0.0009580898931005164,0.9990419101068995
1804,Every Day,10421847,6102076,4319771,movies-2018.csv,2018,0.5855081157879213,0.4144918842120787
1805,The Perfect Match,10414738,9669521,745217,movies-2016.csv,2016,0.9284459196189093,0.07155408038109072
1806,Swing Kids,10397408,222001,10175407,movies-2018.csv,2018,0.0213515714685814,0.9786484285314186
1807,Lobster Cop,10373129,85693,10287436,movies-2018.csv,2018,0.008261056042010082,0.9917389439579899
1808,Queen of Katwe,10367161,8874389,1492772,movies-2016.csv,2016,0.8560095671322168,0.14399043286778318
1809,I'm Your Hero,10338463,274579,10063884,movies-2014.csv,2014,0.026558976900144634,0.9734410230998554
1810,Kin,10313019,5718096,4594923,movies-2018.csv,2018,0.5544541321993104,0.4455458678006896
1811,The Babadook,10312540,964413,9348127,movies-2014.csv,2014,0.09351847362531442,0.9064815263746856
1812,3-D Sex and Zen: Extreme Ecstasy,10306807,153215,10153592,movies-2011.csv,2011,0.014865418553000944,0.9851345814469991
1813,English Vinglish,10299150,1862086,8437064,movies-2012.csv,2012,0.18079996892947475,0.8192000310705252
1814,Girls vs Gangsters,10265819,37115,10228704,movies-2018.csv,2018,0.0036153959075257416,0.9963846040924743
1815,Chennai Express,10234653,5307960,4926693,movies-2013.csv,2013,0.5186262787805312,0.4813737212194688
1816,The Miracle Season,10230620,10230620,0,movies-2018.csv,2018,1.0,0.0
1817,The Best of Enemies,10209813,10205616,4197,movies-2019.csv,2019,0.9995889248902012,0.0004110751097987789
1818,My Spy,10200000,0,10200000,movies-2020.csv,2020,0.0,1.0
1819,BTS World Tour: Love Yourself in Seoul,10195760,3509917,6685843,movies-2019.csv,2019,0.34425261088923237,0.6557473891107676
1820,For Greater Glory: The True Story of Cristiada,10173682,5672846,4500836,movies-2012.csv,2012,0.557600090114867,0.44239990988513306
1821,Ben Is Back,10134204,3703184,6431020,movies-2018.csv,2018,0.36541439268441805,0.634585607315582
1822,Trespass,10117966,24094,10093872,movies-2011.csv,2011,0.00238130865432835,0.9976186913456716
1823,Marshall,10116816,10051659,65157,movies-2017.csv,2017,0.9935595349366836,0.006440465063316364
1824,Iron Sky,10109659,122082,9987577,movies-2012.csv,2012,0.012075778223578065,0.9879242217764219
1825,Bernie,10090641,9206470,884171,movies-2012.csv,2012,0.9123771225237326,0.08762287747626736
1826,A Little Chaos,10084623,558173,9526450,movies-2015.csv,2015,0.05534892082728328,0.9446510791727167
1827,Gladiators of Rome,10079201,8201,10071000,movies-2012.csv,2012,0.000813655764975815,0.9991863442350242
1828,Papillon,10060903,2335896,7725007,movies-2018.csv,2018,0.23217558105867833,0.7678244189413217
1829,The King's Choice,10017316,113231,9904085,movies-2016.csv,2016,0.01130352681297066,0.9886964731870294
1830,Thank You for Your Service,9995692,9536300,459392,movies-2017.csv,2017,0.9540410008631719,0.045958999136828146
1831,Alan Partridge,9979601,153426,9826175,movies-2013.csv,2013,0.015373961343745106,0.9846260386562549
1832,The Goldfinch,9932621,5332621,4600000,movies-2019.csv,2019,0.5368795406569927,0.4631204593430073
1833,The Collection,9929706,6842058,3087648,movies-2012.csv,2012,0.6890494038796314,0.3109505961203685
1834,Portrait of a Lady on Fire,9919850,3759854,6159996,movies-2019.csv,2019,0.37902327152124277,0.6209767284787573
1835,The Princess and the Matchmaker,9899017,78900,9820117,movies-2018.csv,2018,0.007970488382836398,0.9920295116171636
1836,Arctic Dogs,9877855,5801249,4076606,movies-2019.csv,2019,0.5872984570030639,0.41270154299693607
1837,Young & Beautiful,9757417,61067,9696350,movies-2013.csv,2013,0.0062585210819625725,0.9937414789180374
1838,Tamjung Hong Gil-dong: Sarajin Ma-eul,9754195,67054,9687141,movies-2016.csv,2016,0.006874375589169583,0.9931256244108304
1839,Maudie,9733932,6170998,3562934,movies-2017.csv,2017,0.6339676504828675,0.3660323495171324
1840,Popstar: Never Stop Never Stopping,9680029,9639125,40904,movies-2016.csv,2016,0.9957743928246496,0.0042256071753504045
1841,Tod@s Caen,9667157,2670925,6996232,movies-2019.csv,2019,0.2762885717072765,0.7237114282927235
1842,In Darkness,9661759,1041455,8620304,movies-2012.csv,2012,0.10779144874137307,0.892208551258627
1843,Overdrive,9650552,7793,9642759,movies-2017.csv,2017,0.0008075185751032687,0.9991924814248967
1844,On the Road,9617377,744296,8873081,movies-2012.csv,2012,0.07739074801788472,0.9226092519821153
1845,Paterson,9588282,2152738,7435544,movies-2016.csv,2016,0.22451759345417668,0.7754824065458233
1846,Hysteria,9584256,1804139,7780117,movies-2011.csv,2011,0.1882398592024253,0.8117601407975746
1847,God of War,9559524,53000,9506524,movies-2017.csv,2017,0.005544209104972172,0.9944557908950278
1848,Agent Vinod,9520886,698210,8822676,movies-2012.csv,2012,0.07333456151034683,0.9266654384896532
1849,Traffik,9515914,9186156,329758,movies-2018.csv,2018,0.9653466813592473,0.034653318640752745
1850,The Young and Prodigious T.S. Spivet,9494789,173564,9321225,movies-2013.csv,2013,0.01827992175497528,0.9817200782450247
1851,The Square,9493791,1502347,7991444,movies-2017.csv,2017,0.15824521521487042,0.8417547847851296
1852,Our Time Will Come,9484714,114560,9370154,movies-2017.csv,2017,0.012078382120957996,0.987921617879042
1853,The Mayor 2017 Re-release,9476194,96777,9379417,movies-2017.csv,2017,0.010212644443539252,0.9897873555564608
1854,Official Secrets,9473603,1988546,7485057,movies-2019.csv,2019,0.20990387712045777,0.7900961228795422
1855,Promare,9467336,2313596,7153740,movies-2019.csv,2019,0.2443766651991648,0.7556233348008352
1856,Come Play,9435603,7504665,1930938,movies-2020.csv,2020,0.7953561632468005,0.20464383675319955
1857,The Big Bad Fox and Other Tales,9399067,35787,9363280,movies-2017.csv,2017,0.0038075055747554517,0.9961924944252446
1858,Bel Ami,9374932,120462,9254470,movies-2012.csv,2012,0.01284937320078695,0.9871506267992131
1859,You Were Never Really Here,9360514,2528078,6832436,movies-2017.csv,2017,0.2700789721590075,0.7299210278409924
1860,Jexi,9341824,6546159,2795665,movies-2019.csv,2019,0.7007367083772933,0.29926329162270665
1861,Saving Private Perez,9330465,1400726,7929739,movies-2011.csv,2011,0.15012392201246133,0.8498760779875387
1862,Replicas,9330075,4046429,5283646,movies-2018.csv,2018,0.4336973711358162,0.5663026288641838
1863,Peeples,9307166,9177065,130101,movies-2013.csv,2013,0.9860214161861945,0.013978583813805406
1864,Mid90s,9303022,7362439,1940583,movies-2018.csv,2018,0.7914029441185886,0.20859705588141145
1865,Jerusalem,9279456,8020721,1258735,movies-2013.csv,2013,0.8643525008362559,0.13564749916374408
1866,The Chef,9245235,342667,8902568,movies-2012.csv,2012,0.03706417413943507,0.9629358258605649
1867,We Need to Talk About Kevin,9232318,1738692,7493626,movies-2011.csv,2011,0.1883267019181965,0.8116732980818036
1868,The Aftermath,9215591,1618497,7597094,movies-2019.csv,2019,0.17562595822666174,0.8243740417733383
1869,Tulip Fever,9204549,2455635,6748914,movies-2017.csv,2017,0.2667849342754327,0.7332150657245673
1870,My Cousin Rachel,9200168,2716368,6483800,movies-2017.csv,2017,0.2952519997460916,0.7047480002539084
1871,Corpus Christi,9174321,127240,9047081,movies-2019.csv,2019,0.013869146283414326,0.9861308537165857
1872,A Hologram for the King,9169507,4212494,4957013,movies-2016.csv,2016,0.4594024520620356,0.5405975479379644
1873,Unfinished Song,9166865,1702668,7464197,movies-2013.csv,2013,0.18574158122760617,0.8142584187723938
1874,The Raid: Redemption,9148519,4105187,5043332,movies-2012.csv,2012,0.4487269469517416,0.5512730530482585
1875,Ruby Sparks,9128263,2540106,6588157,movies-2012.csv,2012,0.2782682751362444,0.7217317248637556
1876,My Piece of the Pie,9123187,6850,9116337,movies-2011.csv,2011,0.0007508341109307526,0.9992491658890692
1877,Searching for Sugar Man,9122406,3696196,5426210,movies-2012.csv,2012,0.40517775683301094,0.5948222431669891
1878,City Of Rock,9118873,312537,8806336,movies-2017.csv,2017,0.034273643245168565,0.9657263567548314
1879,Human Capital,9113941,158549,8955392,movies-2014.csv,2014,0.017396316258795178,0.9826036837412048
1880,Miss Sloane,9101546,3500605,5600941,movies-2016.csv,2016,0.3846165255880704,0.6153834744119295
1881,Inception 10th Anniversary re-release,9100000,0,9100000,movies-2020.csv,2020,0.0,1.0
1882,Meet the Blacks,9097072,9097072,0,movies-2016.csv,2016,1.0,0.0
1883,Tolkien,9090040,4535154,4554886,movies-2019.csv,2019,0.4989146362392245,0.5010853637607755
1884,Murder 2,9078349,59000,9019349,movies-2011.csv,2011,0.006498979054451421,0.9935010209455486
1885,Twice Born,9075131,18295,9056836,movies-2012.csv,2012,0.002015948860683113,0.9979840511393169
1886,Me and Earl and the Dying Girl,9074749,6758416,2316333,movies-2015.csv,2015,0.7447496343976016,0.2552503656023985
1887,Monsieur Lazhar,9074711,2009517,7065194,movies-2012.csv,2012,0.22144143212935377,0.7785585678706463
1888,The Fifth Estate,9058564,3255008,5803556,movies-2013.csv,2013,0.3593293594878835,0.6406706405121165
1889,Frances Ha,9058065,4069826,4988239,movies-2013.csv,2013,0.4493041284203635,0.5506958715796365
1890,Incarnate,9037058,4799774,4237284,movies-2016.csv,2016,0.5311213007596056,0.4688786992403944
1891,Like Crazy,9029150,107362,8921788,movies-2016.csv,2016,0.011890598782831163,0.9881094012171688
1892,Truman,9027600,210840,8816760,movies-2015.csv,2015,0.02335504453010767,0.9766449554698924
1893,"Two Days, One Night",9016922,1436243,7580679,movies-2014.csv,2014,0.15928306799149422,0.8407169320085058
1894,Champion,8974547,97472,8877075,movies-2018.csv,2018,0.010860938162115592,0.9891390618378844
1895,The Lobster 2016 Re-release,8952351,8700374,251977,movies-2016.csv,2016,0.9718535388078506,0.028146461192149416
1896,Downhill,8899195,8287061,612134,movies-2020.csv,2020,0.9312146772826081,0.06878532271739185
1897,Hannah Arendt,8880936,717205,8163731,movies-2013.csv,2013,0.08075781651843905,0.919242183481561
1898,Bluebeard,8855737,43144,8812593,movies-2017.csv,2017,0.0048718700656986535,0.9951281299343013
1899,All Together,8835903,43180,8792723,movies-2012.csv,2012,0.004886880265661585,0.9951131197343385
1900,Morgan,8809407,3915251,4894156,movies-2016.csv,2016,0.4444397903286793,0.5555602096713207
1901,Captive State,8808611,5958315,2850296,movies-2019.csv,2019,0.6764193582847511,0.32358064171524886
1902,The Traitor,8780845,296027,8484818,movies-2019.csv,2019,0.0337128146550816,0.9662871853449184
1903,7 Days in Entebbe,8771432,3326885,5444547,movies-2018.csv,2018,0.379286415262639,0.620713584737361
1904,Sorry We Missed You,8768505,28273,8740232,movies-2019.csv,2019,0.0032243808950328475,0.9967756191049671
1905,Marguerite,8754356,506677,8247679,movies-2015.csv,2015,0.0578771299682124,0.9421228700317876
1906,La folle histoire de Max et Léon,8750678,543,8750135,movies-2016.csv,2016,6.205233468766649e-05,0.9999379476653123
1907,The Villainess,8737458,27741,8709717,movies-2017.csv,2017,0.003174950883884077,0.9968250491161159
1908,Reservation,8726551,651096,8075455,movies-2011.csv,2011,0.07461092016765845,0.9253890798323415
1909,Code Geass: Lelouch of the Re;Surrection 2019 Re-release,8715612,522805,8192807,movies-2019.csv,2019,0.05998488689032967,0.9400151131096703
1910,Mardaani 2,8680109,0,8680109,movies-2019.csv,2019,0.0,1.0
1911,Le Week-end,8652213,2225098,6427115,movies-2013.csv,2013,0.257170968860799,0.7428290311392011
1912,Himmatwala,8644563,270880,8373683,movies-2013.csv,2013,0.03133530289501042,0.9686646971049896
1913,Pope Francis: A Man of His Word,8608385,2008385,6600000,movies-2018.csv,2018,0.23330566651003642,0.7666943334899635
1914,Our Brand Is Crisis,8527658,7002261,1525397,movies-2015.csv,2015,0.8211235722633342,0.1788764277366658
1915,What If,8526288,3493000,5033288,movies-2014.csv,2014,0.40967417474052015,0.5903258252594799
1916,Stronger,8503658,4211129,4292529,movies-2017.csv,2017,0.495213824450607,0.504786175549393
1917,Piranha 3DD,8493728,376512,8117216,movies-2012.csv,2012,0.044328238436644074,0.9556717615633559
1918,Amityville: The Awakening,8481997,742,8481255,movies-2017.csv,2017,8.747939901417083e-05,0.9999125206009858
1919,A-X-L,8467697,6501381,1966316,movies-2018.csv,2018,0.767786211528353,0.232213788471647
1920,Casa de mi Padre,8446952,5909483,2537469,movies-2012.csv,2012,0.6995994531518588,0.3004005468481412
1921,A Street Cat Named Bob,8446262,82703,8363559,movies-2016.csv,2016,0.009791668787920621,0.9902083312120794
1922,Condorito: The Movie,8431194,447719,7983475,movies-2017.csv,2017,0.053102680355830975,0.946897319644169
1923,Raees,8428190,3262954,5165236,movies-2017.csv,2017,0.38714765566509535,0.6128523443349047
1924,Malang,8399765,0,8399765,movies-2020.csv,2020,0.0,1.0
1925,The Golden Era,8396062,102931,8293131,movies-2014.csv,2014,0.012259437817395823,0.9877405621826042
1926,Filth,8377987,34411,8343576,movies-2013.csv,2013,0.004107311219270214,0.9958926887807298
1927,The Love Punch,8366493,266588,8099905,movies-2014.csv,2014,0.031863768965084895,0.9681362310349151
1928,Venus in Fur,8350026,373605,7976421,movies-2013.csv,2013,0.04474297445301368,0.9552570255469863
1929,I Am Not Your Negro,8345298,7123919,1221379,movies-2017.csv,2017,0.8536446511556568,0.14635534884434326
1930,Time Renegades,8312361,59425,8252936,movies-2016.csv,2016,0.007148991724493198,0.9928510082755068
1931,The Office,8290521,63675,8226846,movies-2015.csv,2015,0.007680458200395367,0.9923195417996047
1932,My Worst Nightmare,8226544,21952,8204592,movies-2011.csv,2011,0.0026684352505742387,0.9973315647494257
1933,Cave of Forgotten Dreams,8183347,5304920,2878427,movies-2011.csv,2011,0.6482579805060203,0.35174201949397965
1934,The Big Year,8179416,7204138,975278,movies-2011.csv,2011,0.880764347968119,0.11923565203188101
1935,Walk of Shame,8122990,59209,8063781,movies-2014.csv,2014,0.0072890647409389895,0.992710935259061
1936,Ernest & Celestine,8111137,262075,7849062,movies-2012.csv,2012,0.03231051331027943,0.9676894866897205
1937,The New Year's Eve of Old Lee,8099301,25358,8073943,movies-2016.csv,2016,0.0031308874679432212,0.9968691125320568
1938,The Man Who Invented Christmas,8096007,5676486,2419521,movies-2017.csv,2017,0.7011463799376656,0.29885362006233446
1939,The Company Men,8087000,4441272,3645728,movies-2011.csv,2011,0.5491865957709905,0.4508134042290095
1940,Heroine,8036853,598668,7438185,movies-2012.csv,2012,0.07449035088734358,0.9255096491126564
1941,My King,8003331,54114,7949217,movies-2015.csv,2015,0.0067614347076236135,0.9932385652923764
1942,Disobedience,8003180,3498782,4504398,movies-2018.csv,2018,0.4371739733455951,0.5628260266544048
1943,Life Itself,7997774,4102648,3895126,movies-2018.csv,2018,0.5129737349417476,0.48702626505825247
1944,Denial,7994527,4073489,3921038,movies-2016.csv,2016,0.5095347104337755,0.4904652895662245
1945,Metallica Through the Never,7975812,3419967,4555845,movies-2013.csv,2013,0.42879232860553884,0.5712076713944612
1946,Chasing Mavericks,7942116,6002756,1939360,movies-2012.csv,2012,0.7558131863095428,0.2441868136904573
1947,Suspiria,7942093,2483472,5458621,movies-2018.csv,2018,0.3126974211961507,0.6873025788038493
1948,The Ark of Mr Chow,7894075,54075,7840000,movies-2015.csv,2015,0.006850074264559179,0.9931499257354408
1949,Pavarotti,7885016,4600249,3284767,movies-2019.csv,2019,0.5834165713804512,0.4165834286195488
1950,The Battle of Jangsari,7883200,70853,7812347,movies-2019.csv,2019,0.008987847574589,0.991012152425411
1951,For a Few Bullets,7860447,30142,7830305,movies-2016.csv,2016,0.0038346419739233657,0.9961653580260766
1952,Salut d'Amour,7858183,22480,7835703,movies-2015.csv,2015,0.0028607122028082065,0.9971392877971917
1953,Pele: Birth of a Legend,7846608,57046,7789562,movies-2016.csv,2016,0.007270147814189265,0.9927298521858108
1954,The Lady,7832142,355391,7476751,movies-2011.csv,2011,0.04537596483822689,0.9546240351617731
1955,Renoir,7816573,2293798,5522775,movies-2013.csv,2013,0.2934531539589024,0.7065468460410975
1956,Dongju: The Portrait of a Poet,7809531,56550,7752981,movies-2016.csv,2016,0.007241151869427242,0.9927588481305728
1957,Qué León,7807916,2607916,5200000,movies-2018.csv,2018,0.33400922858288945,0.6659907714171105
1958,Bad Words,7804337,7779614,24723,movies-2014.csv,2014,0.9968321460234226,0.0031678539765773828
1959,Amazing Grace,7796112,4450456,3345656,movies-2018.csv,2018,0.5708558317274046,0.4291441682725954
1960,By the Grace of God,7755652,67059,7688593,movies-2019.csv,2019,0.00864646840781407,0.991353531592186
1961,3 idiotas,7738470,1249233,6489237,movies-2017.csv,2017,0.16143152328561072,0.8385684767143893
1962,Love Live! Sunshine!! The School Idol Movie: Over The Rainbow,7733048,34135,7698913,movies-2019.csv,2019,0.004414171488396296,0.9955858285116037
1963,Explosion,7731410,122700,7608710,movies-2017.csv,2017,0.015870326369963564,0.9841296736300365
1964,Cedar Rapids,7728936,6861102,867834,movies-2011.csv,2011,0.8877162393374716,0.11228376066252845
1965,Spirited Away Studio Ghibli Fest 2020,7724266,0,7724266,movies-2020.csv,2020,0.0,1.0
1966,My Mother,7723656,303002,7420654,movies-2015.csv,2015,0.03923038519581918,0.9607696148041808
1967,The Sweeney,7708312,26650,7681662,movies-2012.csv,2012,0.0034573068656276497,0.9965426931343724
1968,Kevin Hart: Laugh at My Pain,7706436,7706436,0,movies-2011.csv,2011,1.0,0.0
1969,BPM (Beats Per Minute),7704369,125189,7579180,movies-2017.csv,2017,0.01624909191135575,0.9837509080886443
1970,Penguins,7699452,7699452,0,movies-2019.csv,2019,1.0,0.0
1971,No,7699095,2343664,5355431,movies-2012.csv,2012,0.30440772584310233,0.6955922741568976
1972,Declaration of War,7691610,59100,7632510,movies-2011.csv,2011,0.007683696911309856,0.9923163030886901
1973,Finding Fanny,7685784,615691,7070093,movies-2014.csv,2014,0.08010776779571219,0.9198922322042878
1974,Leave No Trace,7682928,6046104,1636824,movies-2018.csv,2018,0.7869530991309563,0.21304690086904368
1975,Princess Mononoke Studio Ghibli Fest 2020,7673132,0,7673132,movies-2020.csv,2020,0.0,1.0
1976,Lolo,7663798,24134,7639664,movies-2015.csv,2015,0.0031490913513117125,0.9968509086486883
1977,Pandas,7635778,7574012,61766,movies-2018.csv,2018,0.9919109748869074,0.008089025113092601
1978,Just Getting Started,7634022,6069605,1564417,movies-2017.csv,2017,0.7950730296559271,0.2049269703440729
1979,The White Crow,7622595,1828784,5793811,movies-2019.csv,2019,0.23991619651837728,0.7600838034816227
1980,Fullmetal Alchemist: The Sacred Star of Milos,7621364,177802,7443562,movies-2011.csv,2011,0.023329419773153465,0.9766705802268465
1981,ABCD (Any Body Can Dance),7610738,222098,7388640,movies-2013.csv,2013,0.029182189690408474,0.9708178103095916
1982,Only Lovers Left Alive,7609187,1879534,5729653,movies-2013.csv,2013,0.24700851746710917,0.7529914825328908
1983,Klovn Forever,7585569,5700,7579869,movies-2015.csv,2015,0.0007514268211125625,0.9992485731788875
1984,Burning,7576345,718991,6857354,movies-2018.csv,2018,0.0948994534963759,0.9051005465036241
1985,Miss You Already,7573997,1162653,6411344,movies-2015.csv,2015,0.15350587015019942,0.8464941298498005
1986,Hippocrates: Diary of a French Doctor,7555591,23050,7532541,movies-2014.csv,2014,0.003050720982647155,0.9969492790173529
1987,"Kiki, Love to Love",7551282,12450,7538832,movies-2016.csv,2016,0.001648726666544833,0.9983512733334552
1988,The Advocate: A Missing Body,7550177,50162,7500015,movies-2015.csv,2015,0.006643817754206292,0.9933561822457937
1989,Take Me Home Tonight,7550073,6928068,622005,movies-2011.csv,2011,0.9176160283483352,0.08238397165166482
1990,A Bigger Splash,7545758,2024099,5521659,movies-2015.csv,2015,0.2682432964322471,0.7317567035677529
1991,Albert Nobbs,7532259,3014696,4517563,movies-2011.csv,2011,0.4002379631396106,0.5997620368603894
1992,Beirut,7509436,5019226,2490210,movies-2018.csv,2018,0.6683892105878524,0.3316107894121476
1993,Where Do We Go Now?,7507008,531997,6975011,movies-2011.csv,2011,0.07086671547439406,0.929133284525606
1994,The Whistleblower,7505141,280851,7224290,movies-2019.csv,2019,0.037421149049698066,0.9625788509503019
1995,Frantz,7478354,880883,6597471,movies-2016.csv,2016,0.11779102727685799,0.882208972723142
1996,The Tall Man,7462847,0,7462847,movies-2012.csv,2012,0.0,1.0
1997,Big Game,7455398,24752,7430646,movies-2015.csv,2015,0.0033200105480619547,0.996679989451938
1998,Black Nativity,7454185,7018189,435996,movies-2013.csv,2013,0.941509903497163,0.058490096502837
1999,I'll See You in My Dreams,7452512,7449681,2831,movies-2015.csv,2015,0.999620128085671,0.00037987191432902086
2000,Yu-Gi-Oh!: The Dark Side of Dimensions,7445186,1015339,6429847,movies-2016.csv,2016,0.13637523629362652,0.8636247637063735
2001,Brittany Runs a Marathon,7442106,7189808,252298,movies-2019.csv,2019,0.9660985747851482,0.033901425214851816
2002,Mayday Life,7435496,85912,7349584,movies-2019.csv,2019,0.011554306531803662,0.9884456934681963
2003,Genius,7435006,1361045,6073961,movies-2016.csv,2016,0.1830590318286226,0.8169409681713774
2004,Beatriz at Dinner,7425391,7115854,309537,movies-2017.csv,2017,0.958313710348721,0.04168628965127897
2005,God's Not Dead: A Light in Darkness,7414178,5728940,1685238,movies-2018.csv,2018,0.7727006284445828,0.2272993715554172
2006,Goodbye Christopher Robin,7401949,1735251,5666698,movies-2017.csv,2017,0.23443163415473411,0.7655683658452659
2007,The Innocents,7400324,1065665,6334659,movies-2016.csv,2016,0.14400247881038722,0.8559975211896128
2008,Return of the Hero,7362730,37108,7325622,movies-2018.csv,2018,0.005039978377585488,0.9949600216224145
2009,Compadres,7353544,3127773,4225771,movies-2016.csv,2016,0.4253422567404234,0.5746577432595766
2010,Lupin III: The First,7334393,136368,7198025,movies-2019.csv,2019,0.018592949682407257,0.9814070503175928
2011,The Young Messiah,7330338,6490401,839937,movies-2016.csv,2016,0.8854163341444828,0.11458366585551717
2012,Even the Rain,7313485,518017,6795468,movies-2011.csv,2011,0.07083039070976423,0.9291696092902357
2013,The Beaver,7294800,970816,6323984,movies-2011.csv,2011,0.13308329220814827,0.8669167077918517
2014,Let Him Go,7291152,7219300,71852,movies-2020.csv,2020,0.9901453158568083,0.009854684143191638
2015,The Midwife,7286136,603582,6682554,movies-2017.csv,2017,0.08283979327314231,0.9171602067268577
2016,A Long Way Down,7257942,13347,7244595,movies-2014.csv,2014,0.0018389510414935804,0.9981610489585064
2017,What We Do in the Shadows,7251226,3469224,3782002,movies-2014.csv,2014,0.4784327505445286,0.5215672494554714
2018,Let There Be Light,7233471,7233471,0,movies-2017.csv,2017,1.0,0.0
2019,Birth of the Dragon,7215027,6901965,313062,movies-2017.csv,2017,0.95660972578481,0.043390274215190046
2020,20th Century Women,7214806,5664764,1550042,movies-2016.csv,2016,0.785158187205588,0.21484181279441195
2021,Grandma,7205073,6980524,224549,movies-2015.csv,2015,0.9688345975120585,0.03116540248794148
2022,Timbuktu,7179391,1076075,6103316,movies-2014.csv,2014,0.1498838829087314,0.8501161170912686
2023,Blade of the Immortal,7162617,150532,7012085,movies-2017.csv,2017,0.021016340815095937,0.978983659184904
2024,Wild Rose,7123449,1635117,5488332,movies-2019.csv,2019,0.22954007251262695,0.770459927487373
2025,Baar Baar Dekho,7122579,981947,6140632,movies-2016.csv,2016,0.13786396753198527,0.8621360324680147
2026,Postman Pat: The Movie,7102455,1519,7100936,movies-2014.csv,2014,0.00021386971124773055,0.9997861302887523
2027,Incendies,7099598,2071334,5028264,movies-2011.csv,2011,0.2917537021110209,0.7082462978889791
2028,In Safe Hands,7086596,1737,7084859,movies-2018.csv,2018,0.0002451106285725897,0.9997548893714274
2029,The Map Against the World,7035812,34034,7001778,movies-2016.csv,2016,0.004837252615618496,0.9951627473843815
2030,Cosmopolis,7029095,763556,6265539,movies-2012.csv,2012,0.10862792436295142,0.8913720756370486
2031,The Killing of a Sacred Deer,7027336,2291901,4735435,movies-2017.csv,2017,0.3261408021474994,0.6738591978525006
2032,The Kid with a Bike,7011798,1470000,5541798,movies-2011.csv,2011,0.20964665553685374,0.7903533444631463
2033,Jessabelle,6998359,0,6998359,movies-2014.csv,2014,0.0,1.0
2034,Goon,6985158,4168528,2816630,movies-2012.csv,2012,0.5967693214670305,0.40323067853296946
2035,11-11-11,6963872,32771,6931101,movies-2011.csv,2011,0.004705859039339034,0.9952941409606609
2036,The Salesman,6953604,2402067,4551537,movies-2016.csv,2016,0.3454420182685123,0.6545579817314877
2037,The Spectacular Now,6918591,6854611,63980,movies-2013.csv,2013,0.9907524523418135,0.009247547658186472
2038,Hasee Toh Phasee,6914987,646035,6268952,movies-2014.csv,2014,0.09342533832673872,0.9065746616732613
2039,Don 2,6913518,3680306,3233212,movies-2011.csv,2011,0.5323347679141068,0.46766523208589317
2040,Barbara,6889185,1013902,5875283,movies-2012.csv,2012,0.147172996515553,0.852827003484447
2041,The Awakening,6879667,209696,6669971,movies-2011.csv,2011,0.03048054506126532,0.9695194549387347
2042,Talvar,6879098,342370,6536728,movies-2015.csv,2015,0.049769606422237336,0.9502303935777626
2043,Antebellum,6852361,0,6852361,movies-2020.csv,2020,0.0,1.0
2044,Dog Days,6842356,6809080,33276,movies-2018.csv,2018,0.995136762834322,0.004863237165678021
2045,Commitment,6834802,76543,6758259,movies-2013.csv,2013,0.011199007666937535,0.9888009923330625
2046,Collide,6817535,2280004,4537531,movies-2016.csv,2016,0.3344323131454404,0.6655676868545596
2047,Race 3,6817391,1690861,5126530,movies-2018.csv,2018,0.2480217138785204,0.7519782861214797
2048,Baahubali: The Beginning,6787855,6738000,49855,movies-2015.csv,2015,0.9926552644392079,0.007344735560792032
2049,A Little Bit of Heaven,6778388,15375,6763013,movies-2011.csv,2011,0.002268238407125706,0.9977317615928742
2050,The Sun Is also a Star,6750029,4950029,1800000,movies-2019.csv,2019,0.7333344790074235,0.26666552099257645
2051,A Letter to Momo,6748888,71712,6677176,movies-2012.csv,2012,0.010625750494007309,0.9893742495059927
2052,Midnight Special,6740647,3712282,3028365,movies-2016.csv,2016,0.5507308126356416,0.44926918736435834
2053,Wild Card,6738764,0,6738764,movies-2015.csv,2015,0.0,1.0
2054,Churchill,6724365,1281258,5443107,movies-2017.csv,2017,0.19053962716182124,0.8094603728381787
2055,Cesar Chavez 2014 Re-release,6719925,5571497,1148428,movies-2014.csv,2014,0.8291010688363337,0.17089893116366625
2056,Pati Patni Aur Woh,6712525,874044,5838481,movies-2019.csv,2019,0.13021091169120413,0.8697890883087959
2057,Jab Tak Hai Jaan,6703114,3047539,3655575,movies-2012.csv,2012,0.45464525890504026,0.5453547410949597
2058,Bleed for This,6698679,5083906,1614773,movies-2016.csv,2016,0.7589415763914049,0.24105842360859506
2059,Fahrenheit 11/9,6674168,6352306,321862,movies-2018.csv,2018,0.9517749628118441,0.048225037188155885
2060,Son of Saul,6659121,1777043,4882078,movies-2015.csv,2015,0.2668584937861919,0.7331415062138081
2061,Fleabag,6645834,326283,6319551,movies-2019.csv,2019,0.04909586968317295,0.9509041303168271
2062,The Conquest,6637166,74474,6562692,movies-2011.csv,2011,0.011220752953896287,0.9887792470461038
2063,Southside with You,6628603,6304223,324380,movies-2016.csv,2016,0.9510635951496869,0.04893640485031311
2064,Pieta,6616296,22080,6594216,movies-2012.csv,2012,0.003337214659078131,0.9966627853409219
2065,The Red Turtle,6591789,921974,5669815,movies-2016.csv,2016,0.13986703761300612,0.8601329623869939
2066,Soorma,6579645,390077,6189568,movies-2018.csv,2018,0.05928541737434163,0.9407145826256583
2067,The Raid 2,6566916,2627209,3939707,movies-2014.csv,2014,0.4000673984561398,0.5999326015438602
2068,A Melody to Remember,6559996,44263,6515733,movies-2016.csv,2016,0.006747412650861372,0.9932525873491387
2069,From the Land of the Moon,6547983,47748,6500235,movies-2016.csv,2016,0.007292016488130773,0.9927079835118692
2070,Chhapaak,6532100,604334,5927766,movies-2020.csv,2020,0.09251756709174691,0.907482432908253
2071,The Measure of a Man,6518931,112391,6406540,movies-2015.csv,2015,0.017240710171652376,0.9827592898283476
2072,The Lobster,6504366,376871,6127495,movies-2015.csv,2015,0.057941235164195866,0.9420587648358041
2073,Wadjda,6499169,1347747,5151422,movies-2012.csv,2012,0.20737220404639423,0.7926277959536058
2074,Everybody Loves Somebody,6481798,1915789,4566009,movies-2017.csv,2017,0.2955644406073747,0.7044355593926254
2075,Gloria,6461559,2107925,4353634,movies-2013.csv,2013,0.32622545116433976,0.6737745488356602
2076,Run the Race,6424420,6424420,0,movies-2019.csv,2019,1.0,0.0
2077,Same Kind of Different as Me,6423605,6423605,0,movies-2017.csv,2017,1.0,0.0
2078,Gotti,6412349,4343227,2069122,movies-2018.csv,2018,0.6773223041977284,0.3226776958022715
2079,The Mustang,6405816,5043620,1362196,movies-2019.csv,2019,0.7873501205779249,0.2126498794220752
2080,A Journey Through Time with Antony,6389648,127381,6262267,movies-2015.csv,2015,0.01993552696486567,0.9800644730351343
2081,"Farewell, My Queen",6366835,1597998,4768837,movies-2012.csv,2012,0.25098781419653565,0.7490121858034644
2082,Hector and the Search for Happiness,6337728,1124445,5213283,movies-2014.csv,2014,0.17742083598412553,0.8225791640158745
2083,Hampstead,6335171,144396,6190775,movies-2017.csv,2017,0.02279275492326884,0.9772072450767312
2084,Closed Circuit,6331939,5750401,581538,movies-2013.csv,2013,0.9081579907829181,0.09184200921708184
2085,The Last Women Standing,6313827,163406,6150421,movies-2015.csv,2015,0.02588065843425865,0.9741193415657413
2086,Lowriders,6312033,6303560,8473,movies-2017.csv,2017,0.9986576432664405,0.0013423567335595363
2087,Absolutely Anything,6303792,20169,6283623,movies-2015.csv,2015,0.003199502775472287,0.9968004972245277
2088,A Late Quartet,6303709,1562548,4741161,movies-2012.csv,2012,0.24787755906879586,0.7521224409312042
2089,My Boyfriend's Meds,6292780,2971116,3321664,movies-2020.csv,2020,0.47214680951820975,0.5278531904817902
2090,Max Steel,6272403,3818664,2453739,movies-2016.csv,2016,0.6088039942586597,0.3911960057413403
2091,Freaky,6218295,4372295,1846000,movies-2020.csv,2020,0.7031340584517138,0.29686594154828616
2092,Norman,6217567,3814868,2402699,movies-2017.csv,2017,0.6135628293189281,0.38643717068107186
2093,Unbroken: Path to Redemption,6216897,6216897,0,movies-2018.csv,2018,1.0,0.0
2094,Attack the Block,6206022,1024175,5181847,movies-2011.csv,2011,0.16502922484000218,0.8349707751599978
2095,Great Expectations,6202879,258656,5944223,movies-2012.csv,2012,0.041699346384154845,0.9583006536158452
2096,Bill & Ted Face the Music,6202513,3439660,2762853,movies-2020.csv,2020,0.5545590956439753,0.44544090435602474
2097,The Snitch Cartel,6197324,0,6197324,movies-2012.csv,2012,0.0,1.0
2098,Never Look Away,6193234,1304042,4889192,movies-2018.csv,2018,0.2105591359861423,0.7894408640138577
2099,Yeh Jawaani Hai Deewani,6189998,3827466,2362532,movies-2013.csv,2013,0.6183307329016907,0.38166926709830923
2100,Immortal Hero,6180032,43007,6137025,movies-2019.csv,2019,0.006959025454884376,0.9930409745451156
2101,The Autopsy of Jane Doe,6170043,10474,6159569,movies-2016.csv,2016,0.0016975570510610704,0.9983024429489389
2102,Tiger & Bunny: The Rising,6168617,34471,6134146,movies-2014.csv,2014,0.005588124534235146,0.9944118754657648
2103,Darker Than Night,6160114,870063,5290051,movies-2014.csv,2014,0.14124137962381866,0.8587586203761813
2104,The Patriarch,6156936,2156047,4000889,movies-2016.csv,2016,0.3501818112125902,0.6498181887874098
2105,Ploey,6146292,77815,6068477,movies-2018.csv,2018,0.012660478870837898,0.9873395211291621
2106,Mobile Suit Gundam Narrative,6126259,259224,5867035,movies-2018.csv,2018,0.04231358811307194,0.957686411886928
2107,The Duelist,6101904,13450,6088454,movies-2016.csv,2016,0.0022042300239400684,0.9977957699760599
2108,The Trip to Italy,6089109,2880537,3208572,movies-2014.csv,2014,0.4730637930771152,0.5269362069228848
2109,Meet the Mormons,6047363,6047363,0,movies-2014.csv,2014,1.0,0.0
2110,She's Funny That Way,6034851,111996,5922855,movies-2015.csv,2015,0.01855820466818485,0.9814417953318152
2111,Matru's Bijlee's Mandola,6009116,0,6009116,movies-2013.csv,2013,0.0,1.0
2112,Blue Exorcist: The Movie,5994921,21796,5973125,movies-2012.csv,2012,0.0036357443242371335,0.9963642556757629
2113,The Broken Circle Breakdown,5990754,175058,5815696,movies-2012.csv,2012,0.029221363454416588,0.9707786365455834
2114,The Rhythm Section,5989583,5437971,551612,movies-2020.csv,2020,0.9079047740051353,0.09209522599486475
2115,"Cyrano, My Love",5985822,351019,5634803,movies-2019.csv,2019,0.058641737091413675,0.9413582629085864
2116,Learning to Drive,5967516,3447633,2519883,movies-2015.csv,2015,0.5777333483479559,0.4222666516520442
2117,The Immigrant,5952884,2025328,3927556,movies-2013.csv,2013,0.340226350790642,0.659773649209358
2118,All Saints,5942565,5802208,140357,movies-2017.csv,2017,0.9763810745023404,0.02361892549765968
2119,Death of a Nation,5885881,5885881,0,movies-2018.csv,2018,1.0,0.0
2120,Maggie's Plan,5883891,3351735,2532156,movies-2016.csv,2016,0.5696460046591618,0.43035399534083824
2121,Blue Story,5881391,0,5881391,movies-2019.csv,2019,0.0,1.0
2122,Twiceborn,5880157,11527,5868630,movies-2020.csv,2020,0.001960321807734045,0.9980396781922659
2123,Testament of Youth,5874883,1822250,4052633,movies-2015.csv,2015,0.31017638989576474,0.6898236101042353
2124,My Life as a Zucchini,5872598,309766,5562832,movies-2016.csv,2016,0.05274769361022157,0.9472523063897784
2125,Tracks,5853509,510007,5343502,movies-2014.csv,2014,0.08712842160147016,0.9128715783985298
2126,20 Feet from Stardom,5839368,4946445,892923,movies-2013.csv,2013,0.847085677765128,0.152914322234872
2127,Puella Magi Madoka Magica the Movie Part 1: Beginnings,5816330,180440,5635890,movies-2012.csv,2012,0.031022999038912855,0.9689770009610872
2128,Phillauri,5805030,467596,5337434,movies-2017.csv,2017,0.08055014358237597,0.919449856417624
2129,Phoenix,5793245,3184472,2608773,movies-2014.csv,2014,0.5496870924671752,0.4503129075328249
2130,The Wizard of Oz 2013 3D/IMAX Release,5787802,5633202,154600,movies-2013.csv,2013,0.9732886508557135,0.026711349144286554
2131,Dylan Dog: Dead of Night,5782515,1186538,4595977,movies-2011.csv,2011,0.20519410671654115,0.7948058932834589
2132,The Skeleton Twins,5776640,5284309,492331,movies-2014.csv,2014,0.9147720820407711,0.08522791795922889
2133,Furie,5756185,594788,5161397,movies-2019.csv,2019,0.10333024390286275,0.8966697560971373
2134,The Disappointments Room,5745040,2423468,3321572,movies-2016.csv,2016,0.42183657555038784,0.5781634244496122
2135,Under the Skin,5735963,2614251,3121712,movies-2014.csv,2014,0.4557649691952336,0.5442350308047663
2136,The Devil's Double,5728213,1361512,4366701,movies-2011.csv,2011,0.2376852955712366,0.7623147044287634
2137,Kingsglaive: Final Fantasy XV,5725482,269980,5455502,movies-2016.csv,2016,0.04715410859731984,0.9528458914026802
2138,Like for Likes,5715555,50839,5664716,movies-2016.csv,2016,0.008894849231614427,0.9911051507683856
2139,Saaho,5708522,2872057,2836465,movies-2019.csv,2019,0.5031174444103045,0.4968825555896956
2140,My Best Friend's Wedding,5707770,78578,5629192,movies-2016.csv,2016,0.013766847648030668,0.9862331523519693
2141,The Viral Factor,5687319,220496,5466823,movies-2012.csv,2012,0.03876976128822737,0.9612302387117726
2142,Wish I Was Here,5670776,3591299,2079477,movies-2014.csv,2014,0.6332993932400081,0.36670060675999194
2143,Mission Mangal,5667057,3659413,2007644,movies-2019.csv,2019,0.6457342850089561,0.35426571499104387
2144,Anomalisa,5659286,3759286,1900000,movies-2015.csv,2015,0.6642686020816053,0.3357313979183946
2145,Cuban Fury,5645773,92384,5553389,movies-2014.csv,2014,0.016363392577066063,0.9836366074229339
2146,Incident in a Ghostland,5643957,0,5643957,movies-2018.csv,2018,0.0,1.0
2147,Things to Come,5638693,388140,5250553,movies-2016.csv,2016,0.0688351006164017,0.9311648993835983
2148,Pagalpanti,5633633,423340,5210293,movies-2019.csv,2019,0.07514511506163074,0.9248548849383692
2149,Wazir,5633588,1124045,4509543,movies-2016.csv,2016,0.19952559541095302,0.800474404589047
2150,Dalida,5623134,3465,5619669,movies-2017.csv,2017,0.0006162044155447833,0.9993837955844552
2151,El Angel,5604680,109608,5495072,movies-2018.csv,2018,0.01955651348515883,0.9804434865148411
2152,The Party,5597950,749827,4848123,movies-2017.csv,2017,0.13394671263587563,0.8660532873641243
2153,Fathers & Daughters,5587709,0,5587709,movies-2015.csv,2015,0.0,1.0
2154,The French Minister,5586646,12027,5574619,movies-2013.csv,2013,0.0021528122598066892,0.9978471877401933
2155,Destroyer,5580940,1533324,4047616,movies-2018.csv,2018,0.2747429644468495,0.7252570355531506
2156,Pawn Sacrifice,5578519,2436633,3141886,movies-2014.csv,2014,0.4367885096384901,0.56321149036151
2157,Knock Knock,5567103,36336,5530767,movies-2015.csv,2015,0.00652691354911163,0.9934730864508884
2158,Dheepan,5562575,261819,5300756,movies-2014.csv,2014,0.047067949645622754,0.9529320503543772
2159,Escobar: Paradise Lost,5552496,195792,5356704,movies-2014.csv,2014,0.03526197947733776,0.9647380205226622
2160,Ek Tha Tiger,5543117,2347774,3195343,movies-2012.csv,2012,0.42354761770318033,0.5764523822968196
2161,Last Cab to Darwin,5543036,34193,5508843,movies-2015.csv,2015,0.006168641156218361,0.9938313588437816
2162,On My Way,5505705,317324,5188381,movies-2013.csv,2013,0.057635489006403355,0.9423645109935966
2163,Warriors of the Dawn,5497176,84532,5412644,movies-2017.csv,2017,0.015377350115768533,0.9846226498842314
2164,Tale of Tales,5497104,118925,5378179,movies-2015.csv,2015,0.021634118619549492,0.9783658813804506
2165,Joker,5491108,169181,5321927,movies-2012.csv,2012,0.03080999317441944,0.9691900068255805
2166,A Wizard's Tale,5487261,2150,5485111,movies-2018.csv,2018,0.0003918166094158816,0.9996081833905841
2167,Chalet Girl,5468650,1710,5466940,movies-2011.csv,2011,0.00031269143207190075,0.9996873085679281
2168,Man of Tai Chi,5464885,100144,5364741,movies-2013.csv,2013,0.018324996774863513,0.9816750032251365
2169,Thank You,5452347,463540,4988807,movies-2011.csv,2011,0.08501659927367058,0.9149834007263294
2170,OK Jaanu,5445281,355922,5089359,movies-2017.csv,2017,0.0653633852871872,0.9346366147128128
2171,Hara-Kiri: Death of a Samurai,5435358,75688,5359670,movies-2011.csv,2011,0.013925117719936755,0.9860748822800632
2172,An Inconvenient Sequel: Truth to Power,5433926,3496795,1937131,movies-2017.csv,2017,0.6435117077413274,0.3564882922586726
2173,Hocus Pocus 2020 Re-release,5432992,4828000,604992,movies-2020.csv,2020,0.8886447835741338,0.11135521642586627
2174,The Salt of the Earth,5412189,1343349,4068840,movies-2014.csv,2014,0.24820807255622448,0.7517919274437755
2175,The Student and Mister Henri,5411932,761,5411171,movies-2015.csv,2015,0.00014061521837303203,0.999859384781627
2176,Lady Macbeth,5401447,1129408,4272039,movies-2017.csv,2017,0.2090936002889596,0.7909063997110404
2177,Truth,5383097,2541854,2841243,movies-2015.csv,2015,0.4721917513282781,0.5278082486717218
2178,After the Storm,5382886,272132,5110754,movies-2016.csv,2016,0.05055503683340126,0.9494449631665988
2179,Madame,5381950,90979,5290971,movies-2017.csv,2017,0.016904467711517202,0.9830955322884828
2180,Won't Back Down,5378228,5310554,67674,movies-2012.csv,2012,0.9874170451680367,0.012582954831963242
2181,Intruders,5348049,69136,5278913,movies-2011.csv,2011,0.01292733106970411,0.9870726689302959
2182,Much Ado About Nothing,5341221,4328849,1012372,movies-2013.csv,2013,0.8104605669752291,0.18953943302477091
2183,Sky on fire,5335450,78366,5257084,movies-2016.csv,2016,0.014687795781049395,0.9853122042189506
2184,Force,5310437,0,5310437,movies-2011.csv,2011,0.0,1.0
2185,The Meddler 2016 Re-release,5294643,4267218,1027425,movies-2016.csv,2016,0.80595008955278,0.19404991044721995
2186,Don't Let Go,5288011,5215062,72949,movies-2019.csv,2019,0.9862048320247443,0.013795167975255724
2187,Talaash,5277766,2871956,2405810,movies-2012.csv,2012,0.5441612985494241,0.45583870145057587
2188,Mustang,5274664,845464,4429200,movies-2015.csv,2015,0.16028774534264173,0.8397122546573582
2189,True Story,5261595,4719695,541900,movies-2015.csv,2015,0.8970084166493241,0.10299158335067599
2190,Les Misérables: The Staged Concert,5257431,459478,4797953,movies-2019.csv,2019,0.08739591637056197,0.912604083629438
2191,The Truth,5252668,9619,5243049,movies-2019.csv,2019,0.0018312598473766094,0.9981687401526234
2192,The Biggest Little Farm,5248412,4366949,881463,movies-2019.csv,2019,0.8320514852873593,0.1679485147126407
2193,Kill the Messenger,5218973,2450846,2768127,movies-2014.csv,2014,0.4696031192343781,0.5303968807656219
2194,The New Girlfriend,5215796,146754,5069042,movies-2014.csv,2014,0.028136453189503578,0.9718635468104965
2195,Mountains May Depart,5210160,82913,5127247,movies-2015.csv,2015,0.015913714741965696,0.9840862852580343
2196,Zindagi Na Milegi Dobara,5192743,3108485,2084258,movies-2011.csv,2011,0.5986209985743566,0.4013790014256434
2197,Oldboy,5186767,2193658,2993109,movies-2013.csv,2013,0.422933592351459,0.577066407648541
2198,MI-5,5161464,0,5161464,movies-2015.csv,2015,0.0,1.0
2199,October Baby 2012 Re-release,5157886,5157886,0,movies-2012.csv,2012,1.0,0.0
2200,The Legend of Chupacabras,5138140,0,5138140,movies-2016.csv,2016,0.0,1.0
2201,In the Fade,5104991,321011,4783980,movies-2017.csv,2017,0.06288179548210761,0.9371182045178924
2202,"Good Day, Ramon",5104868,154356,4950512,movies-2014.csv,2014,0.030237020820126984,0.969762979179873
2203,Action Point,5103663,5059608,44055,movies-2018.csv,2018,0.9913679645384109,0.008632035461589058
2204,Serena,5092129,176391,4915738,movies-2014.csv,2014,0.03463993154925965,0.9653600684507403
2205,Dark Places,5090852,208588,4882264,movies-2014.csv,2014,0.04097310234121911,0.9590268976587809
2206,Locke,5090608,1375769,3714839,movies-2014.csv,2014,0.2702563230168184,0.7297436769831815
2207,The Liberator,5082098,113067,4969031,movies-2014.csv,2014,0.02224809517644091,0.9777519048235591
2208,The Sense of an Ending,5081495,1274420,3807075,movies-2017.csv,2017,0.2507962715696857,0.7492037284303144
2209,Dogman,5080147,148225,4931922,movies-2018.csv,2018,0.029177305302385936,0.9708226946976141
2210,Anthropoid,5079219,2964845,2114374,movies-2016.csv,2016,0.583720646815977,0.416279353184023
2211,Konosuba!: God's Blessing on This Wonderful World! - Legend of Crimson,5078942,1134786,3944156,movies-2019.csv,2019,0.22342960403958148,0.7765703959604185
2212,Doctor Who: The Day of the Doctor,5074950,0,5074950,movies-2013.csv,2013,0.0,1.0
2213,Stand Up Guys,5072654,3310031,1762623,movies-2013.csv,2013,0.652524497038434,0.3474755029615661
2214,Mr. X,5061387,44995,5016392,movies-2015.csv,2015,0.008889855685803121,0.9911101443141969
2215,Table 19,5042014,3614896,1427118,movies-2017.csv,2017,0.7169547724381566,0.28304522756184336
2216,Kedi,5037923,2835047,2202876,movies-2017.csv,2017,0.562741232845361,0.4372587671546389
2217,The Real Exorcist,5035830,0,5035830,movies-2020.csv,2020,0.0,1.0
2218,Breathe,5026154,490131,4536023,movies-2017.csv,2017,0.09751611271759679,0.9024838872824033
2219,Oranges and Sunshine,5017653,143480,4874173,movies-2011.csv,2011,0.028595042343502033,0.9714049576564979
2220,Double Lover,5012423,167581,4844842,movies-2017.csv,2017,0.03343313204013309,0.9665668679598669
2221,Worlds Apart,5011560,60298,4951262,movies-2015.csv,2015,0.012031782518816496,0.9879682174811835
2222,Blindspotting,5006989,4333394,673595,movies-2018.csv,2018,0.8654690473655924,0.13453095263440762
2223,Hands of Stone,4978353,4712792,265561,movies-2016.csv,2016,0.9466568561932028,0.053343143806797146
2224,Take This Waltz,4965950,1239692,3726258,movies-2012.csv,2012,0.24963843776115346,0.7503615622388465
2225,The Professor and the Madman,4957273,0,4957273,movies-2019.csv,2019,0.0,1.0
2226,Swiss Army Man,4935501,4210454,725047,movies-2016.csv,2016,0.8530955621323955,0.14690443786760451
2227,Nymphomaniac: Vol. II,4934725,327167,4607558,movies-2014.csv,2014,0.06629893256463126,0.9337010674353687
2228,Sgt. Stubby: An American Hero,4932694,4015935,916759,movies-2018.csv,2018,0.8141463873493876,0.18585361265061243
2229,Slack Bay,4925446,112621,4812825,movies-2016.csv,2016,0.022865137492117465,0.9771348625078825
2230,Desierto,4924990,2002036,2922954,movies-2016.csv,2016,0.4065055969656791,0.5934944030343209
2231,[REC] 4: Apocalypse,4915757,837,4914920,movies-2014.csv,2014,0.00017026879074779326,0.9998297312092522
2232,Panga,4886124,582720,4303404,movies-2020.csv,2020,0.11926017432222351,0.8807398256777765
2233,Samson,4873825,4719928,153897,movies-2018.csv,2018,0.9684237739352561,0.03157622606474381
2234,The Young Karl Marx,4870373,125659,4744714,movies-2017.csv,2017,0.02580069329392225,0.9741993067060778
2235,Back To The Future Day,4850000,1650000,3200000,movies-2015.csv,2015,0.3402061855670103,0.6597938144329897
2236,90 Minutes in Heaven,4842699,4842699,0,movies-2015.csv,2015,1.0,0.0
2237,RamLeela,4840059,2738863,2101196,movies-2013.csv,2013,0.565873887074517,0.4341261129254829
2238,Jimmy's Hall,4825184,560592,4264592,movies-2014.csv,2014,0.11618043995835185,0.8838195600416482
2239,Predestination,4824499,68372,4756127,movies-2014.csv,2014,0.014171834215324742,0.9858281657846752
2240,Capital,4822849,101700,4721149,movies-2012.csv,2012,0.021087120911311964,0.9789128790886881
2241,Mazinger Z: INFINITY,4812371,220682,4591689,movies-2017.csv,2017,0.04585722921196225,0.9541427707880378
2242,The SpongeBob Movie: Sponge on the Run,4810790,4810790,0,movies-2020.csv,2020,1.0,0.0
2243,Trash,4809022,17484,4791538,movies-2014.csv,2014,0.00363566646191263,0.9963643335380874
2244,Robot & Frank,4806423,3325038,1481385,movies-2012.csv,2012,0.6917905477732609,0.3082094522267391
2245,A Royal Night Out,4779170,228136,4551034,movies-2015.csv,2015,0.04773548545040247,0.9522645145495975
2246,Martha Marcy May Marlene,4778439,2990625,1787814,movies-2011.csv,2011,0.6258581515846493,0.3741418484153507
2247,Gladiator 20th Anniversary,4777216,0,4777216,movies-2020.csv,2020,0.0,1.0
2248,Men & Chicken,4765472,30207,4735265,movies-2015.csv,2015,0.00633872153692226,0.9936612784630777
2249,The Broken Hearts Gallery,4753131,4067442,685689,movies-2020.csv,2020,0.8557395114925299,0.14426048850747014
2250,The Double,4729855,137921,4591934,movies-2011.csv,2011,0.02915966768537302,0.970840332314627
2251,Clouds of Sils Maria,4728401,1851517,2876884,movies-2014.csv,2014,0.3915735996164454,0.6084264003835546
2252,Sweet Bean,4720010,124800,4595210,movies-2015.csv,2015,0.026440621947834857,0.9735593780521652
2253,Girl in Progress,4709246,2609412,2099834,movies-2012.csv,2012,0.5541039903203188,0.4458960096796812
2254,"Jeff, Who Lives at Home",4704757,4269426,435331,movies-2012.csv,2012,0.9074700351155225,0.09252996488447757
2255,Unlocked,4699125,0,4699125,movies-2017.csv,2017,0.0,1.0
2256,Menteur,4697364,4697364,0,movies-2019.csv,2019,1.0,0.0
2257,Jay and Silent Bob Reboot,4691248,4589490,101758,movies-2019.csv,2019,0.9783089702356388,0.02169102976436121
2258,Keith Lemon: The Film,4682943,0,4682943,movies-2012.csv,2012,0.0,1.0
2259,Warriors of the Rainbow: Seediq Bale I,4670432,136166,4534266,movies-2011.csv,2011,0.029154904728299225,0.9708450952717008
2260,Where to Invade Next,4664756,3827261,837495,movies-2016.csv,2016,0.8204632782507809,0.17953672174921903
2261,A Simple Life,4663094,191826,4471268,movies-2012.csv,2012,0.041137064790029966,0.95886293520997
2262,Tubelight,4650456,930058,3720398,movies-2017.csv,2017,0.19999286091514468,0.8000071390848553
2263,Gemma Bovery,4644525,191533,4452992,movies-2014.csv,2014,0.04123844741927323,0.9587615525807268
2264,Everybody Wants Some!!,4644472,3400278,1244194,movies-2016.csv,2016,0.7321129290907556,0.26788707090924435
2265,Housefull 4,4634173,2109160,2525013,movies-2019.csv,2019,0.4551319081096023,0.5448680918903978
2266,Dear White People,4633961,4404154,229807,movies-2014.csv,2014,0.9504080850054629,0.04959191499453707
2267,Killer Joe,4633668,1987762,2645906,movies-2012.csv,2012,0.428982395803929,0.5710176041960711
2268,Hamlet 2018 Re-release,4630718,235229,4395489,movies-2018.csv,2018,0.050797522112121705,0.9492024778878783
2269,Atlas Shrugged: Part I,4627375,4627375,0,movies-2011.csv,2011,1.0,0.0
2270,Heneral Luna,4625639,206040,4419599,movies-2015.csv,2015,0.044543035027160574,0.9554569649728394
2271,Bad Samaritan,4623836,3435047,1188789,movies-2018.csv,2018,0.742899834682718,0.257100165317282
2272,The Last Black Man in San Francisco,4607017,4515719,91298,movies-2019.csv,2019,0.9801828384831226,0.019817161516877405
2273,A Hidden Life,4605404,1730597,2874807,movies-2019.csv,2019,0.3757752848610024,0.6242247151389976
2274,Whitney,4605123,3026351,1578772,movies-2018.csv,2018,0.6571705033720054,0.3428294966279945
2275,The Guilty,4598051,207140,4390911,movies-2018.csv,2018,0.04504952206924195,0.954950477930758
2276,The Book of Henry,4596705,4504974,91731,movies-2017.csv,2017,0.9800441838229775,0.019955816177022453
2277,Labyrinth of Lies,4574756,794452,3780304,movies-2014.csv,2014,0.17365997224770022,0.8263400277522998
2278,Find a Boyfriend for My Wife... PLEASE!,4570757,1741889,2828868,movies-2016.csv,2016,0.38109420387038734,0.6189057961296127
2279,The Beach Bum,4554416,3502600,1051816,movies-2019.csv,2019,0.7690557911266779,0.23094420887332207
2280,The Iceman,4552970,1969193,2583777,movies-2013.csv,2013,0.432507352343635,0.567492647656365
2281,Colossal,4531320,3029287,1502033,movies-2017.csv,2017,0.6685219759363717,0.33147802406362825
2282,Cezanne et Moi,4529583,257597,4271986,movies-2016.csv,2016,0.05686991495685144,0.9431300850431485
2283,"Juliet, Naked",4511157,3444895,1066262,movies-2018.csv,2018,0.7636389068258985,0.23636109317410145
2284,Maps to the Stars,4510934,350741,4160193,movies-2014.csv,2014,0.07775352066778188,0.9222464793322181
2285,Simon and the Oaks,4505573,150664,4354909,movies-2011.csv,2011,0.03343947595566646,0.9665605240443336
2286,Barfi!,4490134,2804874,1685260,movies-2012.csv,2012,0.6246748983437911,0.3753251016562089
2287,Rundskop,4483147,151840,4331307,movies-2011.csv,2011,0.03386906563625953,0.9661309343637404
2288,Woman at War,4481653,847495,3634158,movies-2018.csv,2018,0.189103217049602,0.810896782950398
2289,The Wall,4476705,1803064,2673641,movies-2017.csv,2017,0.4027658735610231,0.5972341264389769
2290,Batman: The Killing Joke,4462034,3775000,687034,movies-2016.csv,2016,0.8460267223423219,0.1539732776576781
2291,Flypaper,4453634,5043,4448591,movies-2011.csv,2011,0.0011323337301628288,0.9988676662698371
2292,Buck,4448728,4038912,409816,movies-2011.csv,2011,0.9078801850776221,0.09211981492237781
2293,In Harm's Way,4447734,0,4447734,movies-2017.csv,2017,0.0,1.0
2294,Mental,4446852,17669,4429183,movies-2012.csv,2012,0.003973372624049553,0.9960266273759505
2295,Leviathan,4439481,1092800,3346681,movies-2014.csv,2014,0.24615489963804327,0.7538451003619567
2296,Swift,4428275,0,4428275,movies-2019.csv,2019,0.0,1.0
2297,Samsara,4426444,2672413,1754031,movies-2012.csv,2012,0.6037381247791681,0.3962618752208319
2298,Safety Not Guaranteed,4424699,4010957,413742,movies-2012.csv,2012,0.906492622436012,0.09350737756398797
2299,Don't Think Twice,4417667,4417667,0,movies-2016.csv,2016,1.0,0.0
2300,The Commune,4410339,38737,4371602,movies-2016.csv,2016,0.008783225053675013,0.991216774946325
2301,Thérèse,4408087,101944,4306143,movies-2012.csv,2012,0.02312658529652432,0.9768734147034757
2302,The Eagle Huntress,4400140,3169351,1230789,movies-2016.csv,2016,0.7202841273232216,0.27971587267677844
2303,360,4396975,100343,4296632,movies-2012.csv,2012,0.02282091665292616,0.9771790833470738
2304,Kabali,4388789,3903095,485694,movies-2016.csv,2016,0.8893330255794936,0.11066697442050644
2305,White Elephant,4387907,8884,4379023,movies-2012.csv,2012,0.0020246554906473632,0.9979753445093527
2306,Clown,4381603,55007,4326596,movies-2014.csv,2014,0.012554081234653163,0.9874459187653468
2307,Brian Banks,4376819,4376819,0,movies-2019.csv,2019,1.0,0.0
2308,Seven Days in Utopia,4373074,4373074,0,movies-2011.csv,2011,1.0,0.0
2309,There Be Dragons,4372642,1069334,3303308,movies-2011.csv,2011,0.24455100600506513,0.7554489939949349
2310,Mark Felt: The Man Who Brought Down the White House,4372130,768946,3603184,movies-2017.csv,2017,0.17587445935962562,0.8241255406403744
2311,Demolition,4366460,1978592,2387868,movies-2016.csv,2016,0.4531341177979416,0.5468658822020585
2312,Blinky Bill the Movie,4344536,0,4344536,movies-2015.csv,2015,0.0,1.0
2313,Storm Boy,4324268,71760,4252508,movies-2018.csv,2018,0.016594716146177805,0.9834052838538222
2314,Standing Tall,4323120,26144,4296976,movies-2015.csv,2015,0.006047484224356484,0.9939525157756435
2315,The Wretched,4314507,1814193,2500314,movies-2020.csv,2020,0.4204867439084002,0.5795132560915998
2316,Tezz,4305016,229931,4075085,movies-2012.csv,2012,0.05341002216948787,0.9465899778305121
2317,The Grand Seduction,4292517,3430018,862499,movies-2014.csv,2014,0.7990691708384614,0.20093082916153857
2318,High-Rise,4286576,346472,3940104,movies-2016.csv,2016,0.08082721500796906,0.9191727849920309
2319,The Other Side of Hope,4282973,183943,4099030,movies-2017.csv,2017,0.042947503988467826,0.9570524960115322
2320,Linda Ronstadt: The Sound of My Voice,4252657,4252657,0,movies-2019.csv,2019,1.0,0.0
2321,"Don't Worry, He Won't Get Far on Foot",4241656,1441705,2799951,movies-2018.csv,2018,0.3398920138738266,0.6601079861261734
2322,Branded,4227984,353513,3874471,movies-2012.csv,2012,0.08361266267800446,0.9163873373219955
2323,Military Wives,4217455,0,4217455,movies-2020.csv,2020,0.0,1.0
2324,Dabangg 2,4216988,2519190,1697798,movies-2012.csv,2012,0.5973908391487004,0.40260916085129955
2325,No Escape,4215955,167962,4047993,movies-2020.csv,2020,0.03983960929374246,0.9601603907062576
2326,The Rabbi's Cat,4208573,23392,4185181,movies-2011.csv,2011,0.005558178508487319,0.9944418214915127
2327,Diplomacy,4207242,230880,3976362,movies-2014.csv,2014,0.05487680528003856,0.9451231947199614
2328,Let the Sunshine In,4192590,892421,3300169,movies-2017.csv,2017,0.2128567305651161,0.7871432694348839
2329,Sheep & Wolves,4190750,0,4190750,movies-2016.csv,2016,0.0,1.0
2330,Song of the Sea,4190670,857522,3333148,movies-2014.csv,2014,0.20462646784404404,0.795373532155956
2331,Tanu Weds Manu Returns,4180081,3043479,1136602,movies-2015.csv,2015,0.7280909149846618,0.2719090850153382
2332,Nitro Circus: The Movie,4174269,3377618,796651,movies-2012.csv,2012,0.8091519736749117,0.1908480263250883
2333,Krrish 3,4170204,2191534,1978670,movies-2013.csv,2013,0.5255220128319862,0.47447798716801387
2334,The Guardians,4167608,177331,3990277,movies-2017.csv,2017,0.04254982714305184,0.9574501728569481
2335,A Quiet Passion,4159246,1865396,2293850,movies-2016.csv,2016,0.44849378949934676,0.5515062105006533
2336,Savage,4140502,74491,4066011,movies-2019.csv,2019,0.01799081367428394,0.9820091863257161
2337,The Last Princess,4135255,29259,4105996,movies-2016.csv,2016,0.007075500785320373,0.9929244992146796
2338,Ghost Stories,4131358,148747,3982611,movies-2018.csv,2018,0.03600438403062625,0.9639956159693738
2339,Apartment 143,4126744,383,4126361,movies-2012.csv,2012,9.280924622414184e-05,0.9999071907537759
2340,Arctic 2019 Re-release,4124015,2410795,1713220,movies-2019.csv,2019,0.5845747408775186,0.41542525912248135
2341,The Fall of the American Empire,4110928,2178460,1932468,movies-2018.csv,2018,0.5299192785667859,0.4700807214332141
2342,Naam Hai Akira,4108063,219401,3888662,movies-2016.csv,2016,0.05340740879582421,0.9465925912041758
2343,The Hero,4101699,4077333,24366,movies-2017.csv,2017,0.9940595348415376,0.005940465158462384
2344,Force Majeure,4094339,1359497,2734842,movies-2014.csv,2014,0.3320430965779824,0.6679569034220175
2345,2001: A Space Odyssey 2018 Re-release,4084582,3236321,848261,movies-2018.csv,2018,0.7923261180703436,0.20767388192965644
2346,Tere Naal Love Ho Gaya,4083976,177743,3906233,movies-2012.csv,2012,0.043522048121732354,0.9564779518782677
2347,American Animals,4080073,2856954,1223119,movies-2018.csv,2018,0.700221295060162,0.2997787049398381
2348,Katti Batti,4079135,364932,3714203,movies-2015.csv,2015,0.08946308469810389,0.9105369153018961
2349,From Prada to Nada,4058694,3033623,1025071,movies-2011.csv,2011,0.7474382153471043,0.25256178465289575
2350,Two Days in New York,4058113,633210,3424903,movies-2012.csv,2012,0.15603557614093053,0.8439644238590694
2351,Infidel,4051136,4051136,0,movies-2020.csv,2020,1.0,0.0
2352,Film Stars Don't Die in Liverpool,4047917,1026124,3021793,movies-2017.csv,2017,0.2534943280704619,0.7465056719295381
2353,Love in the Buff,4045381,256451,3788930,movies-2012.csv,2012,0.06339353450268342,0.9366064654973165
2354,Junglee,4033587,295784,3737803,movies-2019.csv,2019,0.07333026410487738,0.9266697358951226
2355,Vulgaria,4028543,59059,3969484,movies-2012.csv,2012,0.014660138913746235,0.9853398610862537
2356,Jeepers Creepers III,4017852,2335162,1682690,movies-2017.csv,2017,0.5811966194872284,0.4188033805127715
2357,A Perfect Day,4009440,14044,3995396,movies-2015.csv,2015,0.0035027335488247734,0.9964972664511752
2358,Penguin Highway,4006647,104567,3902080,movies-2018.csv,2018,0.026098381015347744,0.9739016189846522
2359,Faces Places,3996577,953717,3042860,movies-2017.csv,2017,0.23863346058389467,0.7613665394161053
2360,Ride Your Wave,3995885,332432,3663453,movies-2019.csv,2019,0.08319358540098126,0.9168064145990188
2361,Sleight,3989705,3986245,3460,movies-2017.csv,2017,0.999132767961541,0.0008672320384589838
2362,The Invisible Woman,3986888,1234254,2752634,movies-2013.csv,2013,0.3095782976597286,0.6904217023402714
2363,The Nile Hilton Incident,3979536,81089,3898447,movies-2017.csv,2017,0.02037649615432553,0.9796235038456744
2364,Ip Man: The Final Fight,3967001,37884,3929117,movies-2013.csv,2013,0.009549783324985298,0.9904502166750146
2365,Lucifer,3956978,0,3956978,movies-2019.csv,2019,0.0,1.0
2366,The Devil's Violinist,3952097,11294,3940803,movies-2013.csv,2013,0.002857723380777344,0.9971422766192226
2367,Bully 2012 Re-release,3950244,3863446,86798,movies-2012.csv,2012,0.978027180093179,0.021972819906820946
2368,2:22,3945729,422,3945307,movies-2017.csv,2017,0.00010695108559153454,0.9998930489144084
2369,Terminator 2: Judgment Day 2017 Re-release,3931111,1037809,2893302,movies-2017.csv,2017,0.2639989051441183,0.7360010948558817
2370,Welcome to the Punch,3926386,9747,3916639,movies-2013.csv,2013,0.002482435501756577,0.9975175644982435
2371,Loveless,3925992,566356,3359636,movies-2017.csv,2017,0.1442580626756244,0.8557419373243756
2372,Seven Sins Forgiven,3924850,270207,3654643,movies-2011.csv,2011,0.06884517879664191,0.9311548212033581
2373,Indignation,3924527,3401155,523372,movies-2016.csv,2016,0.86664074422217,0.13335925577783003
2374,100% Wolf,3917529,421216,3496313,movies-2020.csv,2020,0.10752083775257311,0.8924791622474268
2375,A Private War,3915207,1633208,2281999,movies-2018.csv,2018,0.4171447384518877,0.5828552615481123
2376,The To Do List,3909596,3491669,417927,movies-2013.csv,2013,0.8931022540436403,0.10689774595635969
2377,The Starving Games,3906308,0,3906308,movies-2013.csv,2013,0.0,1.0
2378,Taxi,3906227,321642,3584585,movies-2015.csv,2015,0.08234083682284721,0.9176591631771528
2379,The Wall,3889260,38674,3850586,movies-2012.csv,2012,0.009943793935093051,0.990056206064907
2380,Rules Don't Apply,3885342,3652206,233136,movies-2016.csv,2016,0.9399960157947486,0.06000398420525143
2381,Neruda,3884746,939101,2945645,movies-2016.csv,2016,0.2417406440472556,0.7582593559527444
2382,"The Night Is Short, Walk on Girl",3878208,406490,3471718,movies-2017.csv,2017,0.10481387279898345,0.8951861272010165
2383,Django,3876874,56556,3820318,movies-2017.csv,2017,0.014588041808941946,0.9854119581910581
2384,Horns,3875442,173948,3701494,movies-2014.csv,2014,0.044884686701542685,0.9551153132984573
2385,Submarine,3875173,467602,3407571,movies-2011.csv,2011,0.1206660967136177,0.8793339032863823
2386,First Reformed,3862498,3448256,414242,movies-2018.csv,2018,0.8927528247263817,0.10724717527361827
2387,Marley,3842919,1413480,2429439,movies-2012.csv,2012,0.36781415377217164,0.6321858462278284
2388,Elles,3822241,157508,3664733,movies-2012.csv,2012,0.04120828592440927,0.9587917140755907
2389,The Other Son,3820405,1285918,2534487,movies-2012.csv,2012,0.3365920628833854,0.6634079371166146
2390,The Homesman,3819421,2429989,1389432,movies-2014.csv,2014,0.6362192070473509,0.3637807929526491
2391,Brad's Status,3816527,2133158,1683369,movies-2017.csv,2017,0.558926479493005,0.441073520506995
2392,Sweet 20,3810429,71775,3738654,movies-2015.csv,2015,0.01883646172123926,0.9811635382787607
2393,Custody,3790303,83882,3706421,movies-2018.csv,2018,0.022130684538940553,0.9778693154610595
2394,The Paperboy,3783865,693286,3090579,movies-2012.csv,2012,0.18322165299237683,0.8167783470076232
2395,Citizenfour,3780692,2800870,979822,movies-2014.csv,2014,0.7408352756585302,0.25916472434146975
2396,Green Room,3769214,3220371,548843,movies-2016.csv,2016,0.8543879440116693,0.1456120559883307
2397,Black Sea,3758103,1171559,2586544,movies-2014.csv,2014,0.3117421209583665,0.6882578790416335
2398,The Trip,3741198,2030962,1710236,movies-2011.csv,2011,0.542864077228738,0.457135922771262
2399,Take Shelter,3741098,1730296,2010802,movies-2011.csv,2011,0.46251020422346595,0.5374897957765341
2400,Like Crazy,3731489,3395391,336098,movies-2011.csv,2011,0.9099292534427945,0.09007074655720544
2401,Ragnarok,3721345,1369,3719976,movies-2013.csv,2013,0.00036787774312782074,0.9996321222568721
2402,Free Fire,3719383,1799312,1920071,movies-2017.csv,2017,0.4837662590811433,0.5162337409188567
2403,Summertime,3719031,35322,3683709,movies-2015.csv,2015,0.009497635271123043,0.990502364728877
2404,Night of 7 Years,3716820,24281,3692539,movies-2018.csv,2018,0.006532734972368853,0.9934672650276312
2405,The Last King,3705618,8905,3696713,movies-2016.csv,2016,0.0024031079296354886,0.9975968920703645
2406,A Fantastic Woman,3702353,2020988,1681365,movies-2017.csv,2017,0.5458658318102029,0.4541341681897971
2407,Spare Parts,3701281,3618912,82369,movies-2015.csv,2015,0.9777458128685718,0.02225418713142828
2408,Western Stars,3681681,1581681,2100000,movies-2019.csv,2019,0.4296083772602787,0.5703916227397213
2409,1911,3680151,135739,3544412,movies-2011.csv,2011,0.03688408437588566,0.9631159156241144
2410,Gosnell: The Trial of America's Biggest Serial Killer,3679893,3679893,0,movies-2018.csv,2018,1.0,0.0
2411,5 Flights Up,3679847,1020921,2658926,movies-2015.csv,2015,0.2774357194742064,0.7225642805257936
2412,Number One Fan,3650598,15549,3635049,movies-2014.csv,2014,0.004259302174602627,0.9957406978253974
2413,Non-Fiction,3649042,704919,2944123,movies-2018.csv,2018,0.19317919607392844,0.8068208039260716
2414,A la mala,3646627,3629842,16785,movies-2015.csv,2015,0.9953971162940438,0.0046028837059562165
2415,Celeste & Jesse Forever,3640975,3094813,546162,movies-2012.csv,2012,0.84999567423561,0.15000432576439005
2416,The German Doctor,3635718,418392,3217326,movies-2013.csv,2013,0.11507823214011648,0.8849217678598835
2417,Crooked House,3625952,0,3625952,movies-2017.csv,2017,0.0,1.0
2418,Colonia,3621046,15709,3605337,movies-2016.csv,2016,0.004338249224119219,0.9956617507758808
2419,The Insult,3601603,1001305,2600298,movies-2017.csv,2017,0.2780164832159458,0.7219835167840543
2420,Phoenix Forgotten,3600146,3600146,0,movies-2017.csv,2017,1.0,0.0
2421,Heart Blackened,3593480,37047,3556433,movies-2017.csv,2017,0.010309504992375079,0.989690495007625
2422,Badla,3590894,1861000,1729894,movies-2019.csv,2019,0.5182553425414396,0.48174465745856043
2423,Indivisible,3589633,3511417,78216,movies-2018.csv,2018,0.9782105858732634,0.02178941412673663
2424,Ghostbusters 30th Anniversary Release,3580343,3580343,0,movies-2014.csv,2014,1.0,0.0
2425,The Apparition,3562793,28293,3534500,movies-2018.csv,2018,0.007941241604550137,0.9920587583954499
2426,Bacurau,3541476,58115,3483361,movies-2019.csv,2019,0.016409824604204575,0.9835901753957954
2427,The Oscar Nominated Short Films 2019: Documentary,3538550,3531094,7456,movies-2019.csv,2019,0.9978929222421613,0.0021070777578386627
2428,Ek Ladki Ko Dekha Toh Aisa Laga,3531837,1182636,2349201,movies-2019.csv,2019,0.33485010774846063,0.6651498922515393
2429,The Riot Club,3517925,7734,3510191,movies-2014.csv,2014,0.0021984550551816767,0.9978015449448183
2430,The Oscar Nominated Short Films 2018: Live Action,3511123,3508777,2346,movies-2018.csv,2018,0.9993318377054863,0.0006681622945137496
2431,Ladrones,3504414,3063505,440909,movies-2015.csv,2015,0.8741846711033571,0.12581532889664293
2432,Thanks for Sharing,3499442,1065881,2433561,movies-2013.csv,2013,0.3045859882804173,0.6954140117195827
2433,Faustina: Love and Mercy,3498887,2243180,1255707,movies-2019.csv,2019,0.6411124451861406,0.35888755481385937
2434,The Empty Man,3497994,2940461,557533,movies-2020.csv,2020,0.8406135059122457,0.1593864940877543
2435,Maiden,3495241,3168978,326263,movies-2019.csv,2019,0.9066550775754805,0.09334492242451951
2436,Racetime,3493043,1875283,1617760,movies-2018.csv,2018,0.5368622716639904,0.4631377283360096
2437,Veronica Mars,3485383,3322127,163256,movies-2014.csv,2014,0.9531598105574051,0.04684018944259497
2438,The Aeronauts,3485251,0,3485251,movies-2019.csv,2019,0.0,1.0
2439,Jack and the Cuckoo-Clock Heart,3484370,0,3484370,movies-2014.csv,2014,0.0,1.0
2440,Miles Ahead,3473958,2610896,863062,movies-2016.csv,2016,0.7515623389804943,0.2484376610195057
2441,Great Performances at the Met: Puccini: Tosca,3473616,2023749,1449867,movies-2018.csv,2018,0.5826058493512236,0.4173941506487764
2442,Enemy,3468224,1008726,2459498,movies-2014.csv,2014,0.2908479959771918,0.7091520040228082
2443,Til Death Do Us Part,3455267,3455267,0,movies-2017.csv,2017,1.0,0.0
2444,Obsession,3454709,528799,2925910,movies-2016.csv,2016,0.1530661482631388,0.8469338517368612
2445,Words and Pictures,3438874,2171257,1267617,movies-2014.csv,2014,0.63138602926423,0.3686139707357699
2446,A Gentleman,3438746,410055,3028691,movies-2017.csv,2017,0.11924550402966663,0.8807544959703334
2447,The Rider,3434963,2419031,1015932,movies-2018.csv,2018,0.7042378622418931,0.29576213775810684
2448,He Named Me Malala,3433606,2668936,764670,movies-2015.csv,2015,0.7772982689335934,0.22270173106640656
2449,Borg vs. McEnroe,3430165,231346,3198819,movies-2017.csv,2017,0.06744456899303677,0.9325554310069633
2450,Disconnect,3428048,1436900,1991148,movies-2013.csv,2013,0.41915982506662686,0.5808401749333731
2451,Special Forces,3424648,10759,3413889,movies-2011.csv,2011,0.0031416367463167017,0.9968583632536833
2452,Next Time I'll Aim for the Heart,3418213,815,3417398,movies-2014.csv,2014,0.00023842867603627977,0.9997615713239637
2453,Midnight Diner,3412771,18555,3394216,movies-2019.csv,2019,0.005436930869372718,0.9945630691306273
2454,Friends 25th: The One With The Anniversary,3403406,2884827,518579,movies-2019.csv,2019,0.8476294041909781,0.1523705958090219
2455,Honey Boy,3400977,3012615,388362,movies-2019.csv,2019,0.8858086955601288,0.11419130443987124
2456,The Protector 2,3399790,2463,3397327,movies-2013.csv,2013,0.000724456510549181,0.9992755434894508
2457,The Good Lie,3396345,2722209,674136,movies-2014.csv,2014,0.8015113305627078,0.19848866943729215
2458,Rock the Kasbah,3394174,3020664,373510,movies-2015.csv,2015,0.889955553250953,0.11004444674904704
2459,"All's Well, Ends Well 2012",3392158,47919,3344239,movies-2012.csv,2012,0.01412640566860388,0.9858735943313961
2460,Gauguin: Voyage to Tahiti,3389322,200140,3189182,movies-2017.csv,2017,0.059050158114218716,0.9409498418857812
2461,Anything for Alice,3387582,1092,3386490,movies-2014.csv,2014,0.00032235382051268427,0.9996776461794873
2462,Apartment 1303 3D,3377891,0,3377891,movies-2012.csv,2012,0.0,1.0
2463,The Neon Demon,3377430,1333124,2044306,movies-2016.csv,2016,0.39471550853755666,0.6052844914624433
2464,The King's Speech PG-13 Version,3375215,3344306,30909,movies-2011.csv,2011,0.9908423611532895,0.009157638846710506
2465,The Hole in the Ground,3373474,21072,3352402,movies-2019.csv,2019,0.006246379844634937,0.9937536201553651
2466,Patrick the Pug,3369468,6290,3363178,movies-2018.csv,2018,0.0018667635365582935,0.9981332364634417
2467,The Last Full Measure,3364426,2949212,415214,movies-2020.csv,2020,0.8765869720421849,0.12341302795781509
2468,Echo in the Canyon,3355324,3355324,0,movies-2019.csv,2019,1.0,0.0
2469,Reality,3350996,72577,3278419,movies-2012.csv,2012,0.021658336804937995,0.978341663195062
2470,Panipat,3349899,461863,2888036,movies-2019.csv,2019,0.13787370902824234,0.8621262909717576
2471,Mistress America,3340737,2500431,840306,movies-2015.csv,2015,0.7484668802123603,0.25153311978763965
2472,Machine Gun Preacher,3338690,538690,2800000,movies-2011.csv,2011,0.16134771422324326,0.8386522857767568
2473,Atlas Shrugged II: The Strike,3336053,3336053,0,movies-2012.csv,2012,1.0,0.0
2474,On Chesil Beach,3335913,745971,2589942,movies-2018.csv,2018,0.22361824184263798,0.776381758157362
2475,The Program,3335613,13074,3322539,movies-2015.csv,2015,0.003919519440654536,0.9960804805593455
2476,By the Sea,3334927,538460,2796467,movies-2015.csv,2015,0.16146080558884798,0.838539194411152
2477,Raiders of the Lost Ark 2012 IMAX Release,3332854,3125613,207241,movies-2012.csv,2012,0.9378187583374489,0.062181241662551075
2478,Last Ounce of Courage,3329674,3329674,0,movies-2012.csv,2012,1.0,0.0
2479,Vanishing Time: A Boy Who Returned,3328517,57759,3270758,movies-2016.csv,2016,0.017352773021739112,0.9826472269782609
2480,The Death & Life of John F. Donovan,3326364,152713,3173651,movies-2019.csv,2019,0.04590988839465555,0.9540901116053444
2481,Obvious Child,3325417,3123963,201454,movies-2014.csv,2014,0.9394199283879285,0.06058007161207151
2482,Flying Swords of Dragon Gate,3323381,170276,3153105,movies-2011.csv,2011,0.051235774652379606,0.9487642253476204
2483,Breath,3322479,37108,3285371,movies-2018.csv,2018,0.01116876886204548,0.9888312311379546
2484,Wildlife,3321367,1050616,2270751,movies-2018.csv,2018,0.31632035845481693,0.683679641545183
2485,The Rental,3317792,1637548,1680244,movies-2020.csv,2020,0.4935656002546272,0.5064343997453729
2486,Chhichhore,3311391,2004400,1306991,movies-2019.csv,2019,0.6053045381835005,0.39469546181649945
2487,2020 Oscar Nominated Short Films,3306611,3306611,0,movies-2020.csv,2020,1.0,0.0
2488,Heist,3294317,50136,3244181,movies-2015.csv,2015,0.015218936125454836,0.9847810638745451
2489,Wonderstruck,3285916,1060377,2225539,movies-2017.csv,2017,0.32270362358623894,0.6772963764137611
2490,Good Time,3283369,2026499,1256870,movies-2017.csv,2017,0.6172011126376596,0.3827988873623403
2491,Bharath Ane Nenu,3276257,2663090,613167,movies-2018.csv,2018,0.8128452682436085,0.18715473175639152
2492,Marianne & Leonard: Words of Love,3273573,1012034,2261539,movies-2019.csv,2019,0.30915272089548634,0.6908472791045136
2493,Samsam,3272825,53273,3219552,movies-2020.csv,2020,0.016277375050606127,0.9837226249493939
2494,Chicken with Plums,3265941,253874,3012067,movies-2011.csv,2011,0.077733798620367,0.922266201379633
2495,Bilal: A New Breed of Hero,3254027,0,3254027,movies-2016.csv,2016,0.0,1.0
2496,Your Sister's Sister,3242802,1636190,1606612,movies-2012.csv,2012,0.5045605621311446,0.4954394378688554
2497,In Harmony,3242445,3144,3239301,movies-2015.csv,2015,0.0009696386523133006,0.9990303613476867
2498,The Front Runner,3242235,2000105,1242130,movies-2018.csv,2018,0.616890817599588,0.3831091824004121
2499,Sleeping with Other People,3224947,819431,2405516,movies-2015.csv,2015,0.25409130754706977,0.7459086924529302
2500,Love is in the Air 2013 Re-release,3221554,8425,3213129,movies-2013.csv,2013,0.0026151975102698885,0.9973848024897302
2501,Embrace of the Serpent,3217176,1329249,1887927,movies-2015.csv,2015,0.41317260852374876,0.5868273914762512
2502,The Mystery of Happiness,3216374,8528,3207846,movies-2014.csv,2014,0.0026514329490289375,0.9973485670509711
2503,Ava,3207103,497747,2709356,movies-2020.csv,2020,0.15520143880629964,0.8447985611937003
2504,Saint Laurent,3202241,429477,2772764,movies-2014.csv,2014,0.13411763824146902,0.865882361758531
2505,I,3200113,1449232,1750881,movies-2015.csv,2015,0.4528690080631528,0.5471309919368472
2506,Dear Zindagi,3199581,2376479,823102,movies-2016.csv,2016,0.7427469409275778,0.2572530590724223
2507,Fill the Void,3197615,1775316,1422299,movies-2012.csv,2012,0.5552000475354287,0.44479995246457127
2508,Victoria,3191971,0,3191971,movies-2015.csv,2015,0.0,1.0
2509,Empire of Lust,3191168,10654,3180514,movies-2015.csv,2015,0.003338589507039429,0.9966614104929605
2510,Thoroughbreds,3187255,3072605,114650,movies-2018.csv,2018,0.9640286076890616,0.03597139231093841
2511,Showtime Championship Boxing: Floyd Mayweather vs. Conor McGregor,3184384,2620183,564201,movies-2017.csv,2017,0.822822561600611,0.17717743839938901
2512,Tea With the Dames,3181152,889343,2291809,movies-2018.csv,2018,0.2795663332025631,0.7204336667974369
2513,Pastorela,3179022,161194,3017828,movies-2011.csv,2011,0.05070553144960935,0.9492944685503907
2514,Pilgrim's Progress,3173282,1294596,1878686,movies-2019.csv,2019,0.4079675238443983,0.5920324761556017
2515,Rosewater,3171593,3128941,42652,movies-2014.csv,2014,0.9865518684143899,0.013448131585610134
2516,Land of Mine,3169553,435266,2734287,movies-2015.csv,2015,0.1373272508773319,0.8626727491226681
2517,The Lodge,3155858,2138907,1016951,movies-2020.csv,2020,0.6777576811123948,0.3222423188876052
2518,Ingrid Goes West,3146831,3024308,122523,movies-2017.csv,2017,0.9610646393149171,0.03893536068508287
2519,The Secret: Dare to Dream,3134693,0,3134693,movies-2020.csv,2020,0.0,1.0
2520,The Deep Blue Sea,3115609,1126525,1989084,movies-2011.csv,2011,0.3615745749867843,0.6384254250132158
2521,In a World...,3114953,2963902,151051,movies-2013.csv,2013,0.9515077755587323,0.048492224441267655
2522,Close Encounters of the Third Kind 2017 Re-release,3101507,3100479,1028,movies-2017.csv,2017,0.9996685482251048,0.00033145177489523643
2523,Raw,3096815,514870,2581945,movies-2017.csv,2017,0.16625791337228735,0.8337420866277127
2524,Star Wars: Episode V - The Empire Strikes Back 2020 Re-release,3096080,2482000,614080,movies-2020.csv,2020,0.8016588718637762,0.19834112813622387
2525,Aquarius,3085977,285930,2800047,movies-2016.csv,2016,0.09265461148932737,0.9073453885106726
2526,The People Vs. Fritz Bauer,3083973,288483,2795490,movies-2015.csv,2015,0.09354264774691608,0.9064573522530839
2527,Mumbai Diaries,3082958,576639,2506319,movies-2011.csv,2011,0.1870408224828233,0.8129591775171767
2528,3 Hearts,3077754,161129,2916625,movies-2014.csv,2014,0.052352787129835585,0.9476472128701644
2529,Ismael's Ghosts,3075562,102510,2973052,movies-2017.csv,2017,0.03333049374390762,0.9666695062560924
2530,Living Is Easy with Eyes Closed,3075169,11600,3063569,movies-2013.csv,2013,0.003772150408644208,0.9962278495913558
2531,The End of the Tour,3072991,3002884,70107,movies-2015.csv,2015,0.9771860705091554,0.022813929490844587
2532,Jane Got a Gun,3067531,1513793,1553738,movies-2015.csv,2015,0.49348906335420895,0.506510936645791
2533,'71,3062178,1270847,1791331,movies-2014.csv,2014,0.4150140847462166,0.5849859152537834
2534,Remember,3054936,547009,2507927,movies-2015.csv,2015,0.1790574336090838,0.8209425663909162
2535,Starred Up,3025189,54915,2970274,movies-2014.csv,2014,0.018152584846764946,0.981847415153235
2536,The Greatest Miracle,3019382,555166,2464216,movies-2011.csv,2011,0.18386742717549484,0.8161325728245051
2537,All Is True,3019143,1200481,1818662,movies-2019.csv,2019,0.3976231003301268,0.6023768996698732
2538,Top Gun 2013 3D Release,3018873,3018873,0,movies-2013.csv,2013,1.0,0.0
2539,Rigor Mortis,3016904,7865,3009039,movies-2013.csv,2013,0.0026069772190298397,0.9973930227809702
2540,The Second Mother,3003560,376986,2626574,movies-2015.csv,2015,0.1255130578380322,0.8744869421619678
2541,The Imposter,3001877,898317,2103560,movies-2012.csv,2012,0.2992517681437314,0.7007482318562686
2542,Made for More,2999134,2999134,0,movies-2018.csv,2018,1.0,0.0
2543,The Last Word,2982004,1783421,1198583,movies-2017.csv,2017,0.5980612366717147,0.40193876332828526
2544,Memoir of War,2980982,103636,2877346,movies-2018.csv,2018,0.034765724851743486,0.9652342751482565
2545,Love Is Strange 2014 Re-release,2979739,2262223,717516,movies-2014.csv,2014,0.759201728742014,0.24079827125798603
2546,Romeo and Juliet,2966268,1162635,1803633,movies-2013.csv,2013,0.39195210951943654,0.6080478904805634
2547,The Last: Naruto the Movie,2949185,524451,2424734,movies-2015.csv,2015,0.17782912906447035,0.8221708709355297
2548,Sibyl,2943278,0,2943278,movies-2019.csv,2019,0.0,1.0
2549,Filly Brown,2940411,2850357,90054,movies-2013.csv,2013,0.9693736691911436,0.030626330808856312
2550,Brighton Rock,2913599,229653,2683946,movies-2011.csv,2011,0.07882107318131287,0.9211789268186872
2551,The House That Jack Built,2911800,87993,2823807,movies-2018.csv,2018,0.03021945188543169,0.9697805481145683
2552,Children of the Sea,2892603,0,2892603,movies-2019.csv,2019,0.0,1.0
2553,The East,2891812,2301839,589973,movies-2013.csv,2013,0.7959850087073433,0.20401499129265666
2554,The Oscar Nominated Short Films 2017: Live Action,2877797,2835355,42442,movies-2017.csv,2017,0.9852519131822015,0.014748086817798475
2555,Maria By Callas,2869237,1267301,1601936,movies-2017.csv,2017,0.4416857164465675,0.5583142835534325
2556,Starbuck,2865068,340058,2525010,movies-2011.csv,2011,0.11869107469700545,0.8813089253029945
2557,Home Run,2861020,2861020,0,movies-2013.csv,2013,1.0,0.0
2558,The Flowers of War,2855644,311434,2544210,movies-2012.csv,2012,0.10905911241037047,0.8909408875896295
2559,Inhumans,2852282,1521787,1330495,movies-2017.csv,2017,0.5335331499480065,0.46646685005199345
2560,The Salt of Life,2850852,317405,2533447,movies-2011.csv,2011,0.1113368915678541,0.8886631084321459
2561,The Oscar Nominated Short Films 2016: Live Action,2850840,2816816,34024,movies-2016.csv,2016,0.9880652719900099,0.011934728009990039
2562,God Bless the Broken Road,2848233,2846257,1976,movies-2018.csv,2018,0.9993062365333173,0.0006937634666826766
2563,Remember You,2845124,14814,2830310,movies-2016.csv,2016,0.005206802937235776,0.9947931970627643
2564,A Breath Away,2842040,77987,2764053,movies-2018.csv,2018,0.027440500485566705,0.9725594995144333
2565,The Identical,2840991,2827666,13325,movies-2014.csv,2014,0.9953097352297139,0.0046902647702861434
2566,Personal Shopper,2840408,1305195,1535213,movies-2016.csv,2016,0.4595096901571887,0.5404903098428113
2567,The Fluffy Movie: Unity Through Laughter,2827393,2827393,0,movies-2014.csv,2014,1.0,0.0
2568,A Coffee in Berlin,2826333,150275,2676058,movies-2012.csv,2012,0.05316960174190373,0.9468303982580962
2569,Everything Must Go,2820490,2711643,108847,movies-2011.csv,2011,0.9614084786686001,0.03859152133139986
2570,The Informer,2814653,187405,2627248,movies-2019.csv,2019,0.06658191968956742,0.9334180803104326
2571,Captive,2801508,2583301,218207,movies-2015.csv,2015,0.9221108774274427,0.07788912257255735
2572,To the Wonder,2801166,587615,2213551,movies-2013.csv,2013,0.20977514363661418,0.7902248563633858
2573,"Cinco de Mayo, La Batalla",2794852,173472,2621380,movies-2013.csv,2013,0.06206840290648664,0.9379315970935134
2574,After the Wedding,2790019,1574258,1215761,movies-2019.csv,2019,0.564246336673693,0.4357536633263071
2575,Kirk Cameron's Saving Christmas,2783970,2783970,0,movies-2014.csv,2014,1.0,0.0
2576,Kinky Boots the Musical,2780537,900451,1880086,movies-2019.csv,2019,0.3238406825731864,0.6761593174268136
2577,The Wonders,2772358,73378,2698980,movies-2014.csv,2014,0.026467721701165577,0.9735322782988344
2578,Battle for Incheon: Operation Chromite,2749918,1023348,1726570,movies-2016.csv,2016,0.37213764192241366,0.6278623580775863
2579,McQueen,2739246,1257275,1481971,movies-2018.csv,2018,0.4589857939009494,0.5410142060990506
2580,Edie,2731170,71790,2659380,movies-2018.csv,2018,0.02628543810894232,0.9737145618910577
2581,Lucky,2728446,955925,1772521,movies-2017.csv,2017,0.35035511056476837,0.6496448894352316
2582,Cocktail,2724695,1227789,1496906,movies-2012.csv,2012,0.4506152064726511,0.5493847935273489
2583,Chi-Raq,2719699,2653032,66667,movies-2015.csv,2015,0.9754873609175133,0.0245126390824867
2584,Billionaire Boys Club,2713955,1349,2712606,movies-2018.csv,2018,0.0004970605629054277,0.9995029394370946
2585,What Maisie Knew,2711379,1066471,1644908,movies-2013.csv,2013,0.3933315851454186,0.6066684148545813
2586,The Guest,2700051,332890,2367161,movies-2014.csv,2014,0.12329026377649904,0.876709736223501
2587,Gangsterdam,2697522,954,2696568,movies-2017.csv,2017,0.0003536579127065507,0.9996463420872934
2588,Jiro Dreams of Sushi,2692864,2552478,140386,movies-2012.csv,2012,0.9478674006559559,0.05213259934404411
2589,A Hijacking,2688444,414437,2274007,movies-2012.csv,2012,0.15415496845015184,0.8458450315498481
2590,The Cup,2660645,0,2660645,movies-2011.csv,2011,0.0,1.0
2591,Diego Maradona,2656890,0,2656890,movies-2019.csv,2019,0.0,1.0
2592,Hillsong: Let Hope Rise,2649761,2394386,255375,movies-2016.csv,2016,0.9036233833919362,0.0963766166080639
2593,Pioneer,2647820,6871,2640949,movies-2013.csv,2013,0.0025949649145334654,0.9974050350854665
2594,Stories We Tell,2641053,1600145,1040908,movies-2013.csv,2013,0.6058738692483642,0.39412613075163583
2595,The Weasel's Tale,2640752,0,2640752,movies-2019.csv,2019,0.0,1.0
2596,Beautiful Accident,2632092,51766,2580326,movies-2017.csv,2017,0.01966724567378344,0.9803327543262166
2597,Maniac,2631275,31081,2600194,movies-2012.csv,2012,0.011812144302666958,0.988187855697333
2598,Third Person,2624761,1021398,1603363,movies-2014.csv,2014,0.3891394302185989,0.610860569781401
2599,The Happy Prince,2621992,466440,2155552,movies-2018.csv,2018,0.17789527961946489,0.8221047203805351
2600,The Little Mermaid,2613377,147175,2466202,movies-2018.csv,2018,0.05631602329093736,0.9436839767090627
2601,Happy End,2610794,301718,2309076,movies-2017.csv,2017,0.11556560954253764,0.8844343904574624
2602,Poster Boys,2602256,97049,2505207,movies-2017.csv,2017,0.03729417858965452,0.9627058214103454
2603,The Signal,2595622,600896,1994726,movies-2014.csv,2014,0.23150366270589476,0.7684963372941053
2604,Leo Da Vinci: Mission Mona Lisa,2588859,19978,2568881,movies-2018.csv,2018,0.007716913126593608,0.9922830868734064
2605,A Question of Faith,2587072,2587072,0,movies-2017.csv,2017,1.0,0.0
2606,Blancanieves,2585522,279735,2305787,movies-2012.csv,2012,0.10819285235244566,0.8918071476475543
2607,Assassination Nation,2584988,2005142,579846,movies-2018.csv,2018,0.7756871598630245,0.2243128401369755
2608,Metallica & San Francisco Symphony - S&M2,2582847,1252385,1330462,movies-2019.csv,2019,0.4848854771498273,0.5151145228501727
2609,The Gatekeepers,2573616,2415727,157889,movies-2013.csv,2013,0.9386509098482446,0.06134909015175535
2610,Is Genesis History?,2570392,2570392,0,movies-2017.csv,2017,1.0,0.0
2611,Maquia: When the Promised Flower Blooms 2018 Re-release,2569927,18539,2551388,movies-2018.csv,2018,0.007213823583315791,0.9927861764166842
2612,Blood Ties,2566435,42472,2523963,movies-2013.csv,2013,0.016549026178336874,0.9834509738216631
2613,Waves,2563470,1658790,904680,movies-2019.csv,2019,0.6470877365446056,0.35291226345539445
2614,God's Own Country,2559939,335609,2224330,movies-2017.csv,2017,0.1311003895014686,0.8688996104985314
2615,The Only Living Boy in New York,2550321,624332,1925989,movies-2017.csv,2017,0.2448052617690087,0.7551947382309914
2616,"1,000 Times Good Night",2549568,53895,2495673,movies-2013.csv,2013,0.021138875291814144,0.9788611247081859
2617,Words on Bathroom Walls,2545934,2542436,3498,movies-2020.csv,2020,0.9986260445086165,0.0013739554913835157
2618,Disney's Newsies: The Broadway Musical!,2545060,2545060,0,movies-2017.csv,2017,1.0,0.0
2619,The Dinner,2544921,1323312,1221609,movies-2017.csv,2017,0.5199815632783886,0.4800184367216114
2620,El Jeremías,2540144,650465,1889679,movies-2016.csv,2016,0.25607406509237274,0.7439259349076273
2621,In the Name of My Daughter,2537899,277528,2260371,movies-2014.csv,2014,0.10935344550748473,0.8906465544925153
2622,IN OUR HANDS: Battle for Jerusalem,2534370,2534370,0,movies-2017.csv,2017,1.0,0.0
2623,Spirits in the Forest,2531785,704744,1827041,movies-2019.csv,2019,0.2783585494028916,0.7216414505971084
2624,Bucky Larson: Born to Be a Star,2530394,2529395,999,movies-2011.csv,2011,0.9996051998226363,0.00039480017736368326
2625,Ittefaq,2520487,298032,2222455,movies-2017.csv,2017,0.11824381558008433,0.8817561844199157
2626,Restless,2518012,163265,2354747,movies-2011.csv,2011,0.06483884906029042,0.9351611509397095
2627,Birds of Passage,2517405,507259,2010146,movies-2018.csv,2018,0.2015007517662037,0.7984992482337963
2628,LBJ,2510151,2470979,39172,movies-2017.csv,2017,0.9843945643110713,0.015605435688928674
2629,The Rover,2510007,1114423,1395584,movies-2014.csv,2014,0.44399198886696334,0.5560080111330367
2630,Grace Unplugged,2507201,2507201,0,movies-2013.csv,2013,1.0,0.0
2631,I'm in Love with a Church Girl,2503392,2387730,115662,movies-2013.csv,2013,0.953797887026882,0.046202112973118076
2632,The Queen of Versailles,2495706,2401999,93707,movies-2012.csv,2012,0.9624527087725878,0.037547291227412204
2633,Still Life,2495025,9481,2485544,movies-2013.csv,2013,0.0037999619242292163,0.9962000380757707
2634,"One Nation, One King",2481681,6576,2475105,movies-2018.csv,2018,0.0026498167975658434,0.9973501832024342
2635,The Christmas Candle,2476775,2258620,218155,movies-2013.csv,2013,0.9119197343319437,0.08808026566805624
2636,Painted Skin: The Resurrection,2455359,50425,2404934,movies-2012.csv,2012,0.020536711739505303,0.9794632882604947
2637,Piku,2452343,1801807,650536,movies-2015.csv,2015,0.7347287879387182,0.2652712120612818
2638,Footnote,2451259,2007758,443501,movies-2011.csv,2011,0.819072158429607,0.18092784157039302
2639,Love at First Fight,2446362,25229,2421133,movies-2014.csv,2014,0.010312864571964411,0.9896871354280355
2640,Lean on Pete,2443584,1163056,1280528,movies-2018.csv,2018,0.47596317540137767,0.5240368245986223
2641,Coriolanus,2435325,757195,1678130,movies-2012.csv,2012,0.31092154024616836,0.6890784597538316
2642,The Unknown Girl,2432640,150549,2282091,movies-2016.csv,2016,0.061887085635359114,0.9381129143646408
2643,Joe,2431443,373375,2058068,movies-2014.csv,2014,0.15356107463757118,0.8464389253624288
2644,The Grace Card,2430735,2430735,0,movies-2011.csv,2011,1.0,0.0
2645,The Breadwinner 2018 Re-release,2426907,834,2426073,movies-2018.csv,2018,0.0003436472843829615,0.999656352715617
2646,Life of Riley,2423379,11616,2411763,movies-2014.csv,2014,0.004793307196274293,0.9952066928037258
2647,Hearts Beat Loud,2417165,2386251,30914,movies-2018.csv,2018,0.9872106372548005,0.012789362745199439
2648,The Art of Self-Defense,2414269,2410914,3355,movies-2019.csv,2019,0.9986103454089001,0.0013896545910998318
2649,Rodin,2413672,44261,2369411,movies-2017.csv,2017,0.018337620024593233,0.9816623799754067
2650,The Oscar Nominated Short Films 2015: Live Action,2412593,2412593,0,movies-2015.csv,2015,1.0,0.0
2651,Beloved Sisters,2407680,54030,2353650,movies-2014.csv,2014,0.022440689792663476,0.9775593102073366
2652,Sound! Euphonium the Movie - Our Promise: A Brand New Day,2403030,90341,2312689,movies-2019.csv,2019,0.037594620125424985,0.962405379874575
2653,The Stroller Strategy,2401291,3462,2397829,movies-2013.csv,2013,0.0014417244723775669,0.9985582755276224
2654,The Man Who Killed Don Quixote,2390383,391963,1998420,movies-2018.csv,2018,0.1639749780683681,0.8360250219316319
2655,Finding Vivian Maier,2384584,1514782,869802,movies-2014.csv,2014,0.6352395218620942,0.3647604781379058
2656,Laggies,2379154,1066981,1312173,movies-2014.csv,2014,0.44847075893363775,0.5515292410663623
2657,I Wish,2371548,145808,2225740,movies-2011.csv,2011,0.06148220487209198,0.938517795127908
2658,Lore,2362019,970325,1391694,movies-2012.csv,2012,0.4108032153848043,0.5891967846151958
2659,Cake,2360281,1951776,408505,movies-2015.csv,2015,0.8269252686438606,0.17307473135613938
2660,Desi Boyz,2355293,1078826,1276467,movies-2011.csv,2011,0.4580432243461854,0.5419567756538146
2661,Memories of the Sword,2345062,111071,2233991,movies-2015.csv,2015,0.047363779720962604,0.9526362202790374
2662,Terraferma,2343302,19996,2323306,movies-2011.csv,2011,0.008533257770445295,0.9914667422295547
2663,The Nightmare Before Christmas 2020 Re-release,2342526,2286000,56526,movies-2020.csv,2020,0.9758696381598326,0.024130361840167407
2664,1991,2342264,2342264,0,movies-2018.csv,2018,1.0,0.0
2665,Meru,2334228,2334228,0,movies-2015.csv,2015,1.0,0.0
2666,Jem and the Holograms,2333684,2184640,149044,movies-2015.csv,2015,0.9361335982078122,0.0638664017921878
2667,Bhaag Milkha Bhaag,2325917,1636731,689186,movies-2013.csv,2013,0.7036927800949045,0.2963072199050955
2668,The Oranges,2316971,366377,1950594,movies-2012.csv,2012,0.158127572593701,0.841872427406299
2669,Austenland,2313509,2159041,154468,movies-2013.csv,2013,0.9332321594599373,0.06676784054006274
2670,A Aa,2313043,2313043,0,movies-2016.csv,2016,1.0,0.0
2671,WARx2,2310625,2310625,0,movies-2015.csv,2015,1.0,0.0
2672,The Resurrection of Gavin Stone,2308355,2303792,4563,movies-2017.csv,2017,0.9980232676516394,0.001976732348360629
2673,Blackfish,2303417,2073582,229835,movies-2013.csv,2013,0.900219977537719,0.09978002246228104
2674,Piranhas,2298525,23494,2275031,movies-2019.csv,2019,0.010221337596937167,0.9897786624030628
2675,The Remaining,2297261,1169603,1127658,movies-2014.csv,2014,0.509129350126085,0.49087064987391504
2676,3 from Hell,2295825,2172949,122876,movies-2019.csv,2019,0.9464784990145155,0.05352150098548452
2677,Ek Main Aur Ekk Tu,2293823,1155545,1138278,movies-2012.csv,2012,0.5037638039203548,0.4962361960796452
2678,Rock on 2,2293659,98868,2194791,movies-2016.csv,2016,0.043104925361616524,0.9568950746383835
2679,Going Away,2290889,19501,2271388,movies-2014.csv,2014,0.008512415922377732,0.9914875840776223
2680,American Honey,2290649,663246,1627403,movies-2016.csv,2016,0.28954501540829697,0.7104549845917031
2681,RV: Resurrected Victims,2269892,20374,2249518,movies-2017.csv,2017,0.008975757436917704,0.9910242425630823
2682,Luce,2268204,2010613,257591,movies-2019.csv,2019,0.8864339362773366,0.1135660637226634
2683,Sleepwalk with Me,2266067,2266067,0,movies-2012.csv,2012,1.0,0.0
2684,Puzzle,2260946,2032018,228928,movies-2018.csv,2018,0.8987468077521533,0.1012531922478467
2685,Shadow Dancer,2253819,100616,2153203,movies-2012.csv,2012,0.04464244910527421,0.9553575508947258
2686,An Interview with God,2251795,1201434,1050361,movies-2018.csv,2018,0.5335450163092111,0.4664549836907889
2687,Marius,2249781,9781,2240000,movies-2013.csv,2013,0.0043475342711135,0.9956524657288865
2688,My All-American,2246000,2246000,0,movies-2015.csv,2015,1.0,0.0
2689,No culpes al karma de lo que te pasa por gilipollas,2242471,5614,2236857,movies-2016.csv,2016,0.0025034883394255713,0.9974965116605744
2690,Relic,2237347,1047083,1190264,movies-2020.csv,2020,0.468002057794343,0.531997942205657
2691,At War,2235052,4605,2230447,movies-2018.csv,2018,0.002060354747898483,0.9979396452521015
2692,Elena,2227905,233380,1994525,movies-2011.csv,2011,0.10475312008366605,0.895246879916334
2693,Delhi Safari,2225597,0,2225597,movies-2012.csv,2012,0.0,1.0
2694,Heal the Living,2223529,3176,2220353,movies-2016.csv,2016,0.0014283600528709093,0.998571639947129
2695,The Lovers,2216083,2194521,21562,movies-2017.csv,2017,0.9902702200233475,0.0097297799766525
2696,Bill Cunningham: New York,2210382,1510026,700356,movies-2011.csv,2011,0.6831516000401741,0.31684839995982594
2697,Elliot the Littlest Reindeer,2195706,24262,2171444,movies-2018.csv,2018,0.0110497489190265,0.9889502510809735
2698,Goodnight Mommy,2193474,1178196,1015278,movies-2015.csv,2015,0.5371369799687619,0.46286302003123814
2699,3 Faces,2191516,72324,2119192,movies-2018.csv,2018,0.033001812443988546,0.9669981875560114
2700,What Will People Say,2191131,44156,2146975,movies-2017.csv,2017,0.020152149734543486,0.9798478502654565
2701,Anchorman 2: The Legend Continues R-Rated Extended Cut,2185255,2184339,916,movies-2014.csv,2014,0.9995808269515457,0.0004191730484542994
2702,Made in Italy,2180161,101339,2078822,movies-2020.csv,2020,0.04648234694593656,0.9535176530540634
2703,Border,2177678,771930,1405748,movies-2018.csv,2018,0.35447389375288724,0.6455261062471127
2704,The King of Staten Island,2176478,0,2176478,movies-2020.csv,2020,0.0,1.0
2705,Gone with the Wind 2019 Re-release,2176120,2176120,0,movies-2019.csv,2019,1.0,0.0
2706,Veere Di Wedding,2176099,0,2176099,movies-2018.csv,2018,0.0,1.0
2707,The Oscar Nominated Short Films 2014: Live Action,2171849,2171849,0,movies-2014.csv,2014,1.0,0.0
2708,Henry's Crime,2169799,102541,2067258,movies-2011.csv,2011,0.04725829443188056,0.9527417055681194
2709,The Reluctant Fundamentalist,2167020,552959,1614061,movies-2013.csv,2013,0.25517023377726095,0.7448297662227391
2710,The Benefactor,2159380,0,2159380,movies-2015.csv,2015,0.0,1.0
2711,The High Note,2149814,0,2149814,movies-2020.csv,2020,0.0,1.0
2712,The Saratov Approach,2146999,2146999,0,movies-2013.csv,2013,1.0,0.0
2713,The Oscar Nominated Short Films 2013: Live Action,2142342,2142342,0,movies-2013.csv,2013,1.0,0.0
2714,Let Yourself Go,2140190,12189,2128001,movies-2017.csv,2017,0.0056952887360468,0.9943047112639533
2715,The Attack,2139516,1720325,419191,movies-2013.csv,2013,0.80407204246194,0.19592795753806
2716,High Life,2133033,1225852,907181,movies-2018.csv,2018,0.5746990318480774,0.42530096815192264
2717,My Scientology Movie,2130866,22936,2107930,movies-2016.csv,2016,0.010763698890498042,0.989236301109502
2718,Mountain,2129889,365412,1764477,movies-2017.csv,2017,0.17156387022985706,0.8284361297701429
2719,Heleno,2126384,0,2126384,movies-2012.csv,2012,0.0,1.0
2720,Sightseers,2122909,61782,2061127,movies-2012.csv,2012,0.029102519231865333,0.9708974807681346
2721,Jai Ho,2122804,1264515,858289,movies-2014.csv,2014,0.595681466588531,0.404318533411469
2722,Abracadabra,2114260,13975,2100285,movies-2017.csv,2017,0.006609877687701608,0.9933901223122984
2723,"20,000 Days on Earth",2105558,279558,1826000,movies-2014.csv,2014,0.13277145535767715,0.8672285446423228
2724,The Eye of the Storm,2104689,83566,2021123,movies-2011.csv,2011,0.03970467845843258,0.9602953215415674
2725,Once Upon a Time in Anatolia,2099472,152408,1947064,movies-2011.csv,2011,0.07259349017276724,0.9274065098272327
2726,The Wizard of Oz 2019 Re-release,2097514,2076020,21494,movies-2019.csv,2019,0.9897526309717122,0.010247369028287772
2727,Indian Horse,2097362,2097362,0,movies-2018.csv,2018,1.0,0.0
2728,Mary Shelley,2096600,108900,1987700,movies-2018.csv,2018,0.051941238195173135,0.9480587618048268
2729,The Captive,2090612,1075178,1015434,movies-2014.csv,2014,0.5142886389248699,0.48571136107513013
2730,"The Butcher, the Chef, and the Swordsman",2089266,47896,2041370,movies-2011.csv,2011,0.022924797512619263,0.9770752024873808
2731,Lost in Paris,2087225,691597,1395628,movies-2017.csv,2017,0.33134760267819713,0.6686523973218029
2732,Girl Most Likely,2085617,1378591,707026,movies-2013.csv,2013,0.6609991192054917,0.3390008807945083
2733,Equals,2084628,33258,2051370,movies-2016.csv,2016,0.01595392559247981,0.9840460744075202
2734,High Strung,2084451,53447,2031004,movies-2016.csv,2016,0.02564080422135133,0.9743591957786487
2735,I'm Not Ashamed,2082980,2082980,0,movies-2016.csv,2016,1.0,0.0
2736,Wi-heom-han gyan-gye,2074864,54000,2020864,movies-2012.csv,2012,0.02602580217305809,0.973974197826942
2737,Black '47,2073063,57520,2015543,movies-2018.csv,2018,0.027746383009102954,0.9722536169908971
2738,A Fool,2067820,8212,2059608,movies-2015.csv,2015,0.003971332127554622,0.9960286678724454
2739,American Pastoral,2063436,544098,1519338,movies-2016.csv,2016,0.263685425668642,0.7363145743313579
2740,Hotchpotch Again,2057329,1013893,1043436,movies-2017.csv,2017,0.4928200594071245,0.5071799405928755
2741,Under the Silver Lake,2053469,46083,2007386,movies-2018.csv,2018,0.022441536736127986,0.977558463263872
2742,Being 17,2045219,52713,1992506,movies-2016.csv,2016,0.025773767992571944,0.9742262320074281
2743,W.E.,2042203,583455,1458748,movies-2012.csv,2012,0.2856988262185493,0.7143011737814507
2744,Raid,2031135,1010385,1020750,movies-2018.csv,2018,0.49744847092881567,0.5025515290711844
2745,Climax,2027391,817339,1210052,movies-2018.csv,2018,0.40314818404540614,0.5968518159545939
2746,42nd Street: The Musical,2022093,187440,1834653,movies-2019.csv,2019,0.09269603326849953,0.9073039667315005
2747,Graduation,2015002,175975,1839027,movies-2016.csv,2016,0.0873324195211717,0.9126675804788283
2748,The Outpost,2011660,0,2011660,movies-2020.csv,2020,0.0,1.0
2749,Little Men,2008649,702537,1306112,movies-2016.csv,2016,0.34975598026335114,0.6502440197366489
2750,Greater,2000093,2000093,0,movies-2016.csv,2016,1.0,0.0
2751,Peterloo,1998945,151971,1846974,movies-2018.csv,2018,0.07602560350584933,0.9239743964941507
2752,1898: Our Last Men in the Philippines,1995045,2848,1992197,movies-2016.csv,2016,0.001427536722229323,0.9985724632777707
2753,Antboy,1994566,0,1994566,movies-2013.csv,2013,0.0,1.0
2754,The Trip to Spain,1988841,1157604,831237,movies-2017.csv,2017,0.5820495454387756,0.41795045456122437
2755,Summer 1993,1983149,185903,1797246,movies-2017.csv,2017,0.0937413174703464,0.9062586825296536
2756,Great Performances at the Met: Verdi: La Traviata,1982588,1882931,99657,movies-2018.csv,2018,0.9497338831870262,0.05026611681297375
2757,Singham Returns,1974745,1232018,742727,movies-2014.csv,2014,0.6238871347946191,0.37611286520538095
2758,Beloved,1971858,137515,1834343,movies-2011.csv,2011,0.06973879457851427,0.9302612054214857
2759,Diary of a Chambermaid,1971247,54235,1917012,movies-2015.csv,2015,0.027513041237348743,0.9724869587626512
2760,Maquia: When the Promised Flower Blooms,1963575,185699,1777876,movies-2018.csv,2018,0.09457189055676508,0.9054281094432349
2761,Menashe,1962265,1703036,259229,movies-2017.csv,2017,0.8678929706232339,0.13210702937676613
2762,Holy Motors,1954125,641100,1313025,movies-2012.csv,2012,0.3280752254845519,0.6719247745154481
2763,A Ghost Story,1951683,1596371,355312,movies-2017.csv,2017,0.8179458446889172,0.1820541553110828
2764,Deadfall,1946254,66351,1879903,movies-2012.csv,2012,0.03409164476990156,0.9659083552300984
2765,Marie Curie: The Courage of Knowledge,1944392,127986,1816406,movies-2017.csv,2017,0.06582314677287296,0.9341768532271271
2766,V/H/S,1944287,100345,1843942,movies-2012.csv,2012,0.0516101789499184,0.9483898210500816
2767,Housefull 3,1944262,1326999,617263,movies-2016.csv,2016,0.6825206685107255,0.3174793314892746
2768,Another Earth,1938783,1321194,617589,movies-2011.csv,2011,0.6814553253252169,0.3185446746747831
2769,Luka Chuppi,1923586,1042905,880681,movies-2019.csv,2019,0.5421670775312359,0.45783292246876406
2770,Jane,1921221,1723379,197842,movies-2017.csv,2017,0.8970227787433096,0.10297722125669041
2771,The Keeper,1916514,0,1916514,movies-2019.csv,2019,0.0,1.0
2772,Old Fashioned,1914090,1914090,0,movies-2015.csv,2015,1.0,0.0
2773,Professor Marston & the Wonder Women,1899615,1584759,314856,movies-2017.csv,2017,0.8342527301584794,0.16574726984152052
2774,Jurassic Park 2020 Re-release,1899492,1386600,512892,movies-2020.csv,2020,0.7299846485270799,0.2700153514729201
2775,Frank,1897363,645186,1252177,movies-2014.csv,2014,0.3400435235640202,0.6599564764359799
2776,Game of Thrones Season 4 Finale,1896092,1896092,0,movies-2015.csv,2015,1.0,0.0
2777,The Art of Getting By,1892130,1430241,461889,movies-2011.csv,2011,0.7558893944919218,0.2441106055080782
2778,The Mighty Macs,1891936,1891936,0,movies-2011.csv,2011,1.0,0.0
2779,Awake: The Life of Yogananda,1891918,1539680,352238,movies-2014.csv,2014,0.8138196264320123,0.1861803735679876
2780,Red Lips,1889869,136163,1753706,movies-2011.csv,2011,0.07204890921010927,0.9279510907898907
2781,Tusk,1882074,1826705,55369,movies-2014.csv,2014,0.9705808592010728,0.02941914079892714
2782,Kill Your Darlings,1877924,1030064,847860,movies-2013.csv,2013,0.5485120803610796,0.45148791963892043
2783,Fantastic Fungi,1877675,1788322,89353,movies-2019.csv,2019,0.9524129575139467,0.04758704248605323
2784,Red State,1874460,1104682,769778,movies-2011.csv,2011,0.5893334613702079,0.410666538629792
2785,Last Flag Flying,1872950,965481,907469,movies-2017.csv,2017,0.5154867989001308,0.4845132010998692
2786,The Whistleblower,1870392,1124966,745426,movies-2011.csv,2011,0.6014600147990368,0.39853998520096323
2787,Purple Rain 2016 Re-release,1868929,1868075,854,movies-2016.csv,2016,0.9995430538024719,0.000456946197528103
2788,Inseparables,1864605,6258,1858347,movies-2016.csv,2016,0.003356206810557732,0.9966437931894423
2789,Matthias & Maxime,1863999,374739,1489260,movies-2019.csv,2019,0.2010403439057639,0.7989596560942361
2790,A Better Life,1863506,1759252,104254,movies-2011.csv,2011,0.9440549158414301,0.05594508415856992
2791,Girlhood,1862990,60765,1802225,movies-2014.csv,2014,0.03261692225937874,0.9673830777406213
2792,The Hallow,1862407,13906,1848501,movies-2015.csv,2015,0.007466681557790537,0.9925333184422095
2793,The Dark Horse,1862114,67533,1794581,movies-2014.csv,2014,0.036266845101857355,0.9637331548981426
2794,The Pact,1855647,2488,1853159,movies-2018.csv,2018,0.0013407722481700453,0.9986592277518299
2795,Sweet Country,1847693,104297,1743396,movies-2018.csv,2018,0.056447147875756415,0.9435528521242436
2796,Crooked Arrows,1832541,1832541,0,movies-2012.csv,2012,1.0,0.0
2797,99 Homes,1828232,1411927,416305,movies-2015.csv,2015,0.7722909346297406,0.22770906537025937
2798,Grease 2018 Re-release,1827688,1213413,614275,movies-2018.csv,2018,0.6639059839534975,0.33609401604650246
2799,Rams,1826583,149250,1677333,movies-2015.csv,2015,0.08170994693370079,0.9182900530662992
2800,The Little Stranger,1824902,713143,1111759,movies-2018.csv,2018,0.39078427225133183,0.6092157277486682
2801,Infinitely Polar Bear,1824678,1430655,394023,movies-2015.csv,2015,0.7840588860061884,0.21594111399381152
2802,Human Flow,1824537,527845,1296692,movies-2017.csv,2017,0.28930353289629096,0.710696467103709
2803,The Seagull,1820461,1252960,567501,movies-2018.csv,2018,0.688265225127042,0.311734774872958
2804,Luv Shuv Tey Chicken Khurana,1813916,143507,1670409,movies-2012.csv,2012,0.07911446836567956,0.9208855316343204
2805,The Monk,1809527,13472,1796055,movies-2011.csv,2011,0.0074450395047987675,0.9925549604952012
2806,The Other Side of Heaven 2: Fire of Faith,1807216,1807216,0,movies-2019.csv,2019,1.0,0.0
2807,Moses,1807117,1807117,0,movies-2018.csv,2018,1.0,0.0
2808,The Face of Love,1806548,350006,1456542,movies-2013.csv,2013,0.19374298385650424,0.8062570161434958
2809,Elvis & Nixon,1798432,1055287,743145,movies-2016.csv,2016,0.5867817076208608,0.41321829237913915
2810,Mine,1788934,0,1788934,movies-2016.csv,2016,0.0,1.0
2811,Harry Potter IMAX Marathon,1784557,1729226,55331,movies-2016.csv,2016,0.9689945459853622,0.031005454014637807
2812,Soldiers of Fortune,1784286,38898,1745388,movies-2012.csv,2012,0.021800316765361608,0.9781996832346384
2813,Song to Song,1778021,443684,1334337,movies-2017.csv,2017,0.2495381100673164,0.7504618899326836
2814,Tom of Finland,1776931,378296,1398635,movies-2017.csv,2017,0.2128929035511227,0.7871070964488773
2815,The Diary of a Teenage Girl,1775133,1477002,298131,movies-2015.csv,2015,0.832051457552758,0.16794854244724197
2816,Polaroid,1772204,0,1772204,movies-2019.csv,2019,0.0,1.0
2817,Dior and I,1769832,1028953,740879,movies-2015.csv,2015,0.5813845607944709,0.4186154392055291
2818,I Saw the Light,1767963,1646788,121175,movies-2016.csv,2016,0.9314606697085855,0.06853933029141447
2819,Invisible Life,1766249,146535,1619714,movies-2019.csv,2019,0.08296395355354766,0.9170360464464523
2820,Game,1764828,139528,1625300,movies-2011.csv,2011,0.07906039568728511,0.9209396043127149
2821,Great Performances at the Met: Puccini: La Bohème,1764201,1764201,0,movies-2018.csv,2018,1.0,0.0
2822,Tales of the Night,1762194,10975,1751219,movies-2011.csv,2011,0.006228031646912883,0.9937719683530871
2823,Great Performances at the Met: Massenet: Cendrillon,1747259,1243306,503953,movies-2018.csv,2018,0.7115751013444487,0.2884248986555514
2824,Beast,1744071,800365,943706,movies-2018.csv,2018,0.45890620278646915,0.5410937972135309
2825,"Turn Me On, Dammit!",1743743,126085,1617658,movies-2011.csv,2011,0.07230710030090444,0.9276928996990955
2826,Wuthering Heights,1742215,100915,1641300,movies-2011.csv,2011,0.057923390626300426,0.9420766093736995
2827,First Position,1730824,1014071,716753,movies-2012.csv,2012,0.5858891487522706,0.4141108512477294
2828,After Love,1728251,13693,1714558,movies-2016.csv,2016,0.007923038956725614,0.9920769610432744
2829,Girl Rising,1727259,1727259,0,movies-2013.csv,2013,1.0,0.0
2830,Diana Vreeland: The Eye Has to Travel,1721472,1017579,703893,movies-2012.csv,2012,0.5911098176444345,0.40889018235556546
2831,A Faithful Man,1720605,77491,1643114,movies-2018.csv,2018,0.04503706545081527,0.9549629345491847
2832,The Souvenir,1719157,1036737,682420,movies-2019.csv,2019,0.6030496342102554,0.39695036578974463
2833,Weiner,1715955,1676108,39847,movies-2016.csv,2016,0.9767785285744672,0.02322147142553272
2834,"To Joey, with Love",1709073,1709073,0,movies-2016.csv,2016,1.0,0.0
2835,Paradise: Love,1709036,24267,1684769,movies-2012.csv,2012,0.01419923278386178,0.9858007672161382
2836,"Men, Women & Children",1705908,705908,1000000,movies-2014.csv,2014,0.4138019166332534,0.5861980833667466
2837,The Oscar Nominated Short Films 2012: Live Action,1702415,1702415,0,movies-2012.csv,2012,1.0,0.0
2838,Meet the Patels,1700681,1700681,0,movies-2015.csv,2015,1.0,0.0
2839,The Wild Pear Tree,1696258,34014,1662244,movies-2018.csv,2018,0.020052374108184015,0.9799476258918159
2840,Dunkirk 2017 Re-release,1695119,1695119,0,movies-2017.csv,2017,1.0,0.0
2841,Slamma Jamma,1687000,1687000,0,movies-2017.csv,2017,1.0,0.0
2842,Tim's Vermeer,1686917,1671377,15540,movies-2014.csv,2014,0.9907879285110056,0.00921207148899442
2843,Janis: Little Girl Blue,1683166,410465,1272701,movies-2015.csv,2015,0.2438648356727738,0.7561351643272262
2844,The Bride,1682689,0,1682689,movies-2015.csv,2015,0.0,1.0
2845,Detachment,1681521,72689,1608832,movies-2012.csv,2012,0.04322812501300906,0.9567718749869909
2846,The Hunter,1680778,176669,1504109,movies-2011.csv,2011,0.10511144243915616,0.8948885575608438
2847,In Between,1679952,107977,1571975,movies-2016.csv,2016,0.06427386020552968,0.9357261397944703
2848,Final Portrait,1677835,461972,1215863,movies-2017.csv,2017,0.275338158996564,0.724661841003436
2849,Nothing Left to Fear,1675381,7886,1667495,movies-2013.csv,2013,0.0047069890371205115,0.9952930109628795
2850,Ginger & Rosa,1674776,1012973,661803,movies-2012.csv,2012,0.6048408861841822,0.39515911381581775
2851,Equity,1672306,1605463,66843,movies-2016.csv,2016,0.9600294443720229,0.039970555627977175
2852,A Brother's Love,1671969,539524,1132445,movies-2019.csv,2019,0.32268780102980377,0.6773121989701962
2853,Vanishing on 7th Street,1671196,22729,1648467,movies-2011.csv,2011,0.013600439445762197,0.9863995605542378
2854,The Double,1662515,200406,1462109,movies-2014.csv,2014,0.12054387479210714,0.8794561252078928
2855,The Comedian,1659002,1659002,0,movies-2016.csv,2016,1.0,0.0
2856,Rustom,1658594,1087419,571175,movies-2016.csv,2016,0.6556269949125585,0.3443730050874415
2857,Rockstar,1651601,986697,664904,movies-2011.csv,2011,0.5974185048325836,0.40258149516741637
2858,Namaste England,1649863,104156,1545707,movies-2018.csv,2018,0.06313009019536774,0.9368699098046323
2859,Two Lives,1649260,22620,1626640,movies-2012.csv,2012,0.013715241987315524,0.9862847580126844
2860,Dough,1647429,1148304,499125,movies-2016.csv,2016,0.6970279144048089,0.30297208559519107
2861,The Letters,1647416,1647416,0,movies-2015.csv,2015,1.0,0.0
2862,The Little Hours,1647175,1647175,0,movies-2017.csv,2017,1.0,0.0
2863,Short Term 12,1645164,1013100,632064,movies-2013.csv,2013,0.6158048680860996,0.38419513191390037
2864,Deerskin,1641693,0,1641693,movies-2019.csv,2019,0.0,1.0
2865,A Family Man,1641235,0,1641235,movies-2017.csv,2017,0.0,1.0
2866,Sorry Angel,1636273,30628,1605645,movies-2018.csv,2018,0.018718147888524713,0.9812818521114753
2867,Student of the Year 2,1635907,778566,857341,movies-2019.csv,2019,0.47592314233021804,0.524076857669782
2868,Mohenjo Daro,1630231,1264339,365892,movies-2016.csv,2016,0.7755581877660283,0.22444181223397175
2869,Iris,1620708,1310678,310030,movies-2015.csv,2015,0.8087070588903121,0.19129294110968786
2870,All You Need Is Love,1620654,0,1620654,movies-2014.csv,2014,0.0,1.0
2871,I Still See You,1620637,1359,1619278,movies-2018.csv,2018,0.0008385591591454472,0.9991614408408546
2872,Son of Sardaar,1618361,771789,846572,movies-2012.csv,2012,0.4768954516328557,0.5231045483671443
2873,Grand Piano,1618085,22555,1595530,movies-2013.csv,2013,0.013939317155773645,0.9860606828442263
2874,Batman Begins 2012 Re-release,1612434,1508658,103776,movies-2012.csv,2012,0.9356401564343099,0.06435984356569013
2875,Singin' in the Rain 2012 Re-release,1609789,1608925,864,movies-2012.csv,2012,0.9994632836974287,0.0005367163025713307
2876,Walk With Me,1606705,726726,879979,movies-2017.csv,2017,0.4523082955489651,0.5476917044510349
2877,More Than Honey,1604609,79772,1524837,movies-2012.csv,2012,0.049714291768275014,0.950285708231725
2878,We are the Best!,1604273,180590,1423683,movies-2013.csv,2013,0.11256812275716166,0.8874318772428383
2879,Monos,1601199,406473,1194726,movies-2019.csv,2019,0.25385539211553343,0.7461446078844666
2880,Crazy Mad Lover,1597269,993031,604238,movies-2011.csv,2011,0.6217055486583662,0.37829445134163375
2881,Great Performances at the Met: Verdi: Aida,1595902,1595902,0,movies-2018.csv,2018,1.0,0.0
2882,Queen of the Desert,1592853,0,1592853,movies-2015.csv,2015,0.0,1.0
2883,Beanpole,1591621,196258,1395363,movies-2019.csv,2019,0.12330699331059342,0.8766930066894066
2884,I Am,1591034,1591034,0,movies-2011.csv,2011,1.0,0.0
2885,The Crossing,1589212,90896,1498316,movies-2019.csv,2019,0.05719564161357956,0.9428043583864204
2886,Dance Academy: The Movie,1586858,0,1586858,movies-2017.csv,2017,0.0,1.0
2887,Lovelace,1585583,356582,1229001,movies-2013.csv,2013,0.22489015081518912,0.7751098491848109
2888,Make Your Move,1583687,125106,1458581,movies-2012.csv,2012,0.07899667042793178,0.9210033295720682
2889,The Bay,1581252,30668,1550584,movies-2012.csv,2012,0.019394758077776346,0.9806052419222236
2890,Lou!,1581125,287,1580838,movies-2014.csv,2014,0.00018151632540121747,0.9998184836745988
2891,The Stray,1579440,1579440,0,movies-2017.csv,2017,1.0,0.0
2892,Lay the Favorite,1576687,20998,1555689,movies-2012.csv,2012,0.013317798649953985,0.986682201350046
2893,Adore,1575749,318982,1256767,movies-2013.csv,2013,0.2024319863125409,0.7975680136874591
2894,Genesis: Paradise Lost,1575000,1575000,0,movies-2017.csv,2017,1.0,0.0
2895,Teri Meri Kahaani,1574703,781196,793507,movies-2012.csv,2012,0.49609100890771146,0.5039089910922885
2896,Teen Spirit,1573601,441366,1132235,movies-2019.csv,2019,0.2804815197753433,0.7195184802246567
2897,Caesar Must Die,1567339,76908,1490431,movies-2012.csv,2012,0.04906915479038038,0.9509308452096196
2898,"Bless Me, Ultima",1561962,1561962,0,movies-2013.csv,2013,1.0,0.0
2899,Persecuted,1558836,1558836,0,movies-2014.csv,2014,1.0,0.0
2900,The Kid,1553483,1508593,44890,movies-2019.csv,2019,0.9711036425889437,0.028896357411056315
2901,Still Mine,1552730,1159336,393394,movies-2013.csv,2013,0.7466436534362059,0.2533563465637941
2902,Yardie,1551163,36012,1515151,movies-2018.csv,2018,0.0232161288014219,0.9767838711985781
2903,Tel Aviv on Fire,1548893,506145,1042748,movies-2019.csv,2019,0.3267785444184976,0.6732214555815024
2904,Cold in July,1547630,427418,1120212,movies-2014.csv,2014,0.276175830140279,0.723824169859721
2905,Fed Up,1546229,1538899,7330,movies-2014.csv,2014,0.9952594344046063,0.0047405655953936966
2906,"New York, New York",1545352,92377,1452975,movies-2016.csv,2016,0.059777319342130465,0.9402226806578695
2907,The Lords of Salem,1544989,1165882,379107,movies-2013.csv,2013,0.7546215539398662,0.24537844606013376
2908,Mystery Train,1544973,1541218,3755,movies-2018.csv,2018,0.9975695368139119,0.0024304631860880416
2909,Rampart,1543613,972512,571101,movies-2012.csv,2012,0.6300231988199114,0.3699768011800885
2910,The Wedding Plan,1542345,1412404,129941,movies-2016.csv,2016,0.9157510154991263,0.08424898450087367
2911,The Chaperone,1541223,600654,940569,movies-2019.csv,2019,0.38972556210230447,0.6102744378976955
2912,Reaching for the Moon,1534391,45502,1488889,movies-2013.csv,2013,0.029654762052175748,0.9703452379478242
2913,Love,1533874,309200,1224674,movies-2012.csv,2012,0.2015810946661851,0.7984189053338149
2914,The Bullet Vanishes,1528580,117629,1410951,movies-2012.csv,2012,0.07695311988904735,0.9230468801109526
2915,Gold,1528185,5539,1522646,movies-2017.csv,2017,0.0036245611624247066,0.9963754388375753
2916,Certain Women,1526698,1087585,439113,movies-2016.csv,2016,0.7123773005532201,0.28762269944677993
2917,Mandy,1523052,1214525,308527,movies-2018.csv,2018,0.7974284528696328,0.20257154713036718
2918,Shaadi Ke Side Effects,1521778,921277,600501,movies-2014.csv,2014,0.605395136478514,0.39460486352148605
2919,Young Ahmed,1520922,21291,1499631,movies-2019.csv,2019,0.01399874549779673,0.9860012545022032
2920,Princess Mononoke 2018 Re-release,1519321,1423877,95444,movies-2018.csv,2018,0.9371798323066686,0.06282016769333143
2921,The Dark Knight 2012 Re-release,1513086,1513086,0,movies-2012.csv,2012,1.0,0.0
2922,My Golden Days,1509773,269144,1240629,movies-2015.csv,2015,0.17826785881056292,0.821732141189437
2923,Take a Shot,1508912,564489,944423,movies-2011.csv,2011,0.3741033274306255,0.6258966725693745
2924,The Daughter,1505434,26376,1479058,movies-2016.csv,2016,0.01752052896374069,0.9824794710362593
2925,The Kings of Summer,1501595,1315590,186005,movies-2013.csv,2013,0.8761283834855603,0.12387161651443965
2926,Priceless,1499605,1499605,0,movies-2016.csv,2016,1.0,0.0
2927,Moka,1493067,129547,1363520,movies-2016.csv,2016,0.0867656977215356,0.9132343022784644
2928,The Artist and the Model,1492780,127958,1364822,movies-2012.csv,2012,0.08571792226583957,0.9142820777341605
2929,Mully,1489771,1489771,0,movies-2017.csv,2017,1.0,0.0
2930,Patti Cake$,1482356,800148,682208,movies-2017.csv,2017,0.5397812671180202,0.4602187328819798
2931,Oasis: Supersonic,1478119,242867,1235252,movies-2016.csv,2016,0.16430815110285438,0.8356918488971457
2932,The Miseducation of Cameron Post,1474577,904703,569874,movies-2018.csv,2018,0.613533915149904,0.386466084850096
2933,Freeheld,1474471,573335,901136,movies-2015.csv,2015,0.3888411504871917,0.6111588495128083
2934,Good Kill,1474471,316472,1157999,movies-2015.csv,2015,0.21463426544163974,0.7853657345583602
2935,Mausam,1473341,728316,745025,movies-2011.csv,2011,0.4943295543937215,0.5056704456062785
2936,De De Pyaar De,1473116,425934,1047182,movies-2019.csv,2019,0.28913812625753843,0.7108618737424616
2937,A Pigeon Sat on a Branch Reflecting on Existence,1472431,222989,1249442,movies-2014.csv,2014,0.15144275011868127,0.8485572498813188
2938,Jimmy P.,1470582,30283,1440299,movies-2013.csv,2013,0.020592527312315805,0.9794074726876842
2939,Violeta Went to Heaven,1466032,21496,1444536,movies-2011.csv,2011,0.014662708590262696,0.9853372914097374
2940,Thelma,1463727,147391,1316336,movies-2017.csv,2017,0.10069568983833733,0.8993043101616627
2941,Greed,1460431,355308,1105123,movies-2020.csv,2020,0.24328982334666957,0.7567101766533304
2942,Life of Crime,1456675,265452,1191223,movies-2014.csv,2014,0.1822314517651501,0.8177685482348499
2943,The Disappearance of Eleanor Rigby: Them,1448076,587774,860302,movies-2014.csv,2014,0.4058999665763399,0.5941000334236601
2944,Shameless,1443479,679866,763613,movies-2013.csv,2013,0.4709912648538704,0.5290087351461296
2945,The Dawn Wall 2018 Re-release,1442013,970032,471981,movies-2018.csv,2018,0.6726929646265325,0.3273070353734675
2946,Vox Lux,1439539,727119,712420,movies-2018.csv,2018,0.5051054538987829,0.49489454610121714
2947,Tomboy,1437501,129834,1307667,movies-2011.csv,2011,0.09031924151704938,0.9096807584829506
2948,My Friend Dahmer,1436751,1361611,75140,movies-2017.csv,2017,0.947701445831602,0.052298554168398
2949,Kai Po Che,1435272,1122527,312745,movies-2013.csv,2013,0.7821005356475985,0.21789946435240148
2950,The Devil's Hand,1428494,5746,1422748,movies-2014.csv,2014,0.004022418015056416,0.9959775819849436
2951,The Zero Theorem,1428362,257706,1170656,movies-2014.csv,2014,0.18042064966724122,0.8195793503327587
2952,Fairy Tail: Dragon Cry,1420035,519461,900574,movies-2017.csv,2017,0.3658085892249135,0.6341914107750866
2953,Black Butterflies,1416573,0,1416573,movies-2011.csv,2011,0.0,1.0
2954,It 2019 Re-release,1414696,1347126,67570,movies-2019.csv,2019,0.9522370883921352,0.04776291160786487
2955,The Wolfpack,1414140,1301696,112444,movies-2015.csv,2015,0.9204859490573777,0.07951405094262237
2956,Parkland,1412181,653651,758530,movies-2013.csv,2013,0.4628663039652849,0.5371336960347151
2957,Lazer Team,1406538,1186426,220112,movies-2016.csv,2016,0.8435079606807637,0.1564920393192363
2958,Just a Sigh,1406331,75531,1330800,movies-2013.csv,2013,0.053707839761763056,0.9462921602382369
2959,El Chicano,1404646,1400603,4043,movies-2019.csv,2019,0.9971216947188117,0.002878305281188285
2960,Haider,1404307,1048143,356164,movies-2014.csv,2014,0.7463773946864894,0.2536226053135105
2961,Universal Soldier: Day of Reckoning,1402307,5460,1396847,movies-2012.csv,2012,0.0038935839299097845,0.9961064160700902
2962,Saheb Biwi Aur Gangster 3,1401894,0,1401894,movies-2018.csv,2018,0.0,1.0
2963,Born to Be Blue 2016 Re-release,1401411,678203,723208,movies-2016.csv,2016,0.4839429689077651,0.5160570310922349
2964,For Sama,1397546,43796,1353750,movies-2019.csv,2019,0.03133778780805784,0.9686622121919422
2965,Maggie,1394052,187112,1206940,movies-2015.csv,2015,0.1342216789617604,0.8657783210382396
2966,Light of My Life,1392898,20056,1372842,movies-2019.csv,2019,0.014398757123637194,0.9856012428763629
2967,Holiday: A Soldier is Never Off Duty,1390054,706893,683161,movies-2014.csv,2014,0.5085363590191461,0.491463640980854
2968,"Oslo, August 31st",1386378,101475,1284903,movies-2011.csv,2011,0.07319432362602407,0.9268056763739759
2969,"For a Good Time, Call...",1386088,1251749,134339,movies-2012.csv,2012,0.9030804681953816,0.09691953180461847
2970,Alien 2019 Re-release,1385671,833658,552013,movies-2014.csv,2014,0.6016276590907943,0.3983723409092057
2971,National Lampoon's Christmas Vacation 2019 Re-release,1385620,1385620,0,movies-2019.csv,2019,1.0,0.0
2972,House of Tolerance,1384443,19327,1365116,movies-2011.csv,2011,0.013960126924691013,0.9860398730753089
2973,Sometimes Always Never,1377856,0,1377856,movies-2018.csv,2018,0.0,1.0
2974,Swimming with Men,1377748,24708,1353040,movies-2018.csv,2018,0.0179336134039026,0.9820663865960974
2975,Ma ma,1375709,47258,1328451,movies-2015.csv,2015,0.03435174153836313,0.9656482584616368
2976,Khoobsurat,1375623,710508,665115,movies-2014.csv,2014,0.5164990698759762,0.4835009301240238
2977,Stefan Zweig: Farewell to Europe,1370772,78372,1292400,movies-2016.csv,2016,0.057173621871470966,0.942826378128529
2978,A Good Old Fashioned Orgy,1369485,200227,1169258,movies-2011.csv,2011,0.14620605556103206,0.8537939444389679
2979,The Ardennes,1366879,5638,1361241,movies-2015.csv,2015,0.004124725012235904,0.9958752749877641
2980,Sarileru Neekevvaru,1366335,821000,545335,movies-2020.csv,2020,0.600877530034728,0.39912246996527206
2981,The Salvation,1363964,44903,1319061,movies-2014.csv,2014,0.03292095685809889,0.9670790431419011
2982,National Theater Live: Cyrano de Bergerac 2020 Re-release,1363212,198352,1164860,movies-2020.csv,2020,0.14550341399576883,0.8544965860042312
2983,Little Italy,1362536,990230,372306,movies-2018.csv,2018,0.726755109589765,0.27324489041023503
2984,Gimme Shelter,1362018,1359910,2108,movies-2014.csv,2014,0.9984522965188419,0.0015477034811581052
2985,Chasing Ice,1358668,1328467,30201,movies-2012.csv,2012,0.9777716116078394,0.022228388392160556
2986,Foxtrot,1356159,618883,737276,movies-2018.csv,2018,0.45634988227781553,0.5436501177221845
2987,Papa,1356033,26677,1329356,movies-2016.csv,2016,0.019672825071366258,0.9803271749286337
2988,The Oscar Nominated Short Films 2011: Live Action,1352152,1352152,0,movies-2011.csv,2011,1.0,0.0
2989,Unforgivable,1351146,154189,1196957,movies-2011.csv,2011,0.11411720124990193,0.885882798750098
2990,The Teacher,1350426,64437,1285989,movies-2016.csv,2016,0.04771605404516797,0.952283945954832
2991,The Snowtown Murders,1349387,8452,1340935,movies-2011.csv,2011,0.006263584872241989,0.993736415127758
2992,The Cokeville Miracle,1348456,1348456,0,movies-2015.csv,2015,1.0,0.0
2993,Bolshoi Ballet: The Nutcracker,1348248,252935,1095313,movies-2019.csv,2019,0.18760272590799318,0.8123972740920068
2994,2 Hearts,1341495,1341495,0,movies-2020.csv,2020,1.0,0.0
2995,Saint Maud,1340825,0,1340825,movies-2020.csv,2020,0.0,1.0
2996,The Assistant,1338881,1100313,238568,movies-2020.csv,2020,0.8218153816507965,0.17818461834920354
2997,Student of the Year,1337281,670086,667195,movies-2012.csv,2012,0.5010809246523356,0.4989190753476644
2998,Barney Thomson,1336254,0,1336254,movies-2015.csv,2015,0.0,1.0
2999,Great Performances at the Met: Rossini: Semiramide,1332900,1033651,299249,movies-2018.csv,2018,0.7754902843424113,0.2245097156575887
3000,Ghost in the Shell: The New Movie,1332311,101203,1231108,movies-2015.csv,2015,0.0759604927077837,0.9240395072922163
3001,Godard Mon Amour,1332204,82264,1249940,movies-2017.csv,2017,0.06175030250622277,0.9382496974937772
3002,Kapow,1331922,812737,519185,movies-2016.csv,2016,0.6101986452660141,0.3898013547339859
3003,13 Minutes,1328233,161531,1166702,movies-2015.csv,2015,0.1216134518567149,0.8783865481432851
3004,The Ultimate Life,1327841,1327841,0,movies-2013.csv,2013,1.0,0.0
3005,Spirited Away 2019 Re-release,1322927,1322927,0,movies-2019.csv,2019,1.0,0.0
3006,The Look of Love,1318468,21252,1297216,movies-2013.csv,2013,0.016118707469578327,0.9838812925304217
3007,Erased,1314735,0,1314735,movies-2012.csv,2012,0.0,1.0
3008,Damsels in Distress,1314358,1008455,305903,movies-2012.csv,2012,0.7672605180628109,0.2327394819371891
3009,Air Racers,1309987,1309987,0,movies-2012.csv,2012,1.0,0.0
3010,Come What May,1309818,37766,1272052,movies-2015.csv,2015,0.02883301344156211,0.9711669865584379
3011,Dom Hemingway,1307599,523511,784088,movies-2013.csv,2013,0.40036050807625273,0.5996394919237472
3012,Something in the Air,1305473,85154,1220319,movies-2012.csv,2012,0.06522846508506878,0.9347715349149313
3013,Great Performances at the Met: Mozart: Così fan tutte,1302949,1302949,0,movies-2018.csv,2018,1.0,0.0
3014,Les Cowboys,1302493,73725,1228768,movies-2015.csv,2015,0.056602991340452505,0.9433970086595475
3015,Sunset Song,1302482,159714,1142768,movies-2015.csv,2015,0.12262280783918703,0.877377192160813
3016,The Room 2017 Re-release,1301103,549602,751501,movies-2017.csv,2017,0.4224123685826564,0.5775876314173436
3017,Hard to Be a God,1299035,28608,1270427,movies-2014.csv,2014,0.022022501318286265,0.9779774986817137
3018,Slow West,1295574,229094,1066480,movies-2015.csv,2015,0.17682818580798934,0.8231718141920107
3019,Roger Waters - Us + Them,1294480,611644,682836,movies-2019.csv,2019,0.47250169952413323,0.5274983004758668
3020,No Safe Spaces,1291514,1291514,0,movies-2019.csv,2019,1.0,0.0
3021,The Cakemaker,1287568,875751,411817,movies-2018.csv,2018,0.6801590284940291,0.31984097150597096
3022,Filmistaan,1282717,45406,1237311,movies-2014.csv,2014,0.035398299079220125,0.9646017009207799
3023,Black Souls,1278360,101088,1177272,movies-2014.csv,2014,0.07907631653055477,0.9209236834694452
3024,The Villain,1278108,730530,547578,movies-2014.csv,2014,0.5715714165000141,0.4284285834999859
3025,Shed Skin Papa,1278065,13331,1264734,movies-2018.csv,2018,0.0104306119015856,0.9895693880984144
3026,Yellow Submarine,1273261,992305,280956,movies-2018.csv,2018,0.7793413919062941,0.22065860809370585
3027,The Women's Balcony,1272517,1200885,71632,movies-2017.csv,2017,0.94370841411156,0.05629158588844
3028,Beautifully Broken,1271572,1209645,61927,movies-2018.csv,2018,0.9512988647123403,0.04870113528765969
3029,Tai ji 1: Cong ling kai shi,1271521,212094,1059427,movies-2012.csv,2012,0.16680337957454106,0.833196620425459
3030,Texas Killing Fields,1271319,45469,1225850,movies-2011.csv,2011,0.03576521706983062,0.9642347829301694
3031,Fagara,1265949,43417,1222532,movies-2019.csv,2019,0.03429601034480852,0.9657039896551914
3032,Why Don't You Play in Hell?,1265872,28534,1237338,movies-2013.csv,2013,0.022540983606557378,0.9774590163934426
3033,Batla House,1264337,493180,771157,movies-2019.csv,2019,0.39007005252555293,0.6099299474744471
3034,Valley of Love,1264277,28648,1235629,movies-2015.csv,2015,0.02265959121300158,0.9773404087869985
3035,Chonda Pierce: Enough,1260116,1260116,0,movies-2017.csv,2017,1.0,0.0
3036,Meerkats,1259616,777595,482021,movies-2012.csv,2012,0.6173270266493915,0.38267297335060846
3037,The Music of Strangers: Yo-Yo Ma and the Silk Road Ensemble,1259588,1176781,82807,movies-2016.csv,2016,0.9342586623562625,0.06574133764373748
3038,Gett,1259160,988150,271010,movies-2014.csv,2014,0.7847692112201785,0.21523078877982146
3039,Guy,1257937,1319,1256618,movies-2018.csv,2018,0.0010485421765954893,0.9989514578234046
3040,Anna,1257142,4288,1252854,movies-2014.csv,2014,0.0034109114165305114,0.9965890885834695
3041,Chaar Sahibzaade 2: Rise of Banda Singh Bahadur,1256852,700723,556129,movies-2016.csv,2016,0.5575222858379507,0.4424777141620493
3042,For a Woman,1252416,32286,1220130,movies-2013.csv,2013,0.025778974398283,0.974221025601717
3043,Demi-soeur,1251642,943,1250699,movies-2013.csv,2013,0.0007534103202033809,0.9992465896797966
3044,The Ledge,1247188,9216,1237972,movies-2011.csv,2011,0.007389423246535406,0.9926105767534646
3045,Midnight's Children,1243980,190022,1053958,movies-2012.csv,2012,0.15275325969870898,0.847246740301291
3046,Slumber,1243832,0,1243832,movies-2017.csv,2017,0.0,1.0
3047,1945,1240663,1006193,234470,movies-2017.csv,2017,0.811012337758118,0.18898766224188196
3048,The Goonies 2020 Re-release,1236438,825000,411438,movies-2020.csv,2020,0.6672392792845254,0.33276072071547463
3049,Beyond the Mask,1236094,1236094,0,movies-2015.csv,2015,1.0,0.0
3050,The Blue Room,1232900,254666,978234,movies-2014.csv,2014,0.2065585205612783,0.7934414794387217
3051,The Cut,1232140,28066,1204074,movies-2014.csv,2014,0.02277825571769442,0.9772217442823056
3052,Honeyland,1231697,815082,416615,movies-2019.csv,2019,0.6617552855937784,0.33824471440622167
3053,Life,1231606,0,1231606,movies-2015.csv,2015,0.0,1.0
3054,The Perfect Candidate,1231500,0,1231500,movies-2020.csv,2020,0.0,1.0
3055,True to the Game,1231040,1231040,0,movies-2017.csv,2017,1.0,0.0
3056,Steve McQueen: American Icon,1229782,1229782,0,movies-2017.csv,2017,1.0,0.0
3057,Casablanca 2011 Re-release,1226808,1155330,71478,movies-2011.csv,2011,0.9417366042608134,0.05826339573918657
3058,BTS World Tour 'Love Yourself: Speak Yourself' (The Final) Seoul Live Viewing,1226552,1226552,0,movies-2019.csv,2019,1.0,0.0
3059,That Sugar Film,1226399,3500,1222899,movies-2015.csv,2015,0.0028538836055802394,0.9971461163944197
3060,The Revolution Has Begun,1223419,738525,484894,movies-2013.csv,2013,0.6036566376686973,0.3963433623313027
3061,Sister,1218174,154659,1063515,movies-2012.csv,2012,0.12695969541297056,0.8730403045870294
3062,Ilo Ilo,1216181,56773,1159408,movies-2013.csv,2013,0.04668137390733781,0.9533186260926622
3063,Woman Thou Art Loosed: On the 7th Day,1213128,1213128,0,movies-2012.csv,2012,1.0,0.0
3064,Clandestine Childhood,1212354,9017,1203337,movies-2012.csv,2012,0.007437596609571132,0.9925624033904289
3065,Kochadaiiyaan,1210580,817192,393388,movies-2014.csv,2014,0.6750417155413108,0.32495828445868924
3066,The Way He Looks,1207841,101451,1106390,movies-2014.csv,2014,0.08399367135243795,0.916006328647562
3067,Noble 2014 Re-release,1207386,347321,860065,movies-2014.csv,2014,0.2876635972257422,0.7123364027742578
3068,Alone in Berlin,1205598,33125,1172473,movies-2016.csv,2016,0.02747599116786856,0.9725240088321314
3069,Inequality for All,1205273,1205273,0,movies-2013.csv,2013,1.0,0.0
3070,Meek's Cutoff,1205257,977772,227485,movies-2011.csv,2011,0.8112560225744385,0.1887439774255615
3071,In the Land of Blood and Honey,1203699,303877,899822,movies-2011.csv,2011,0.25245264804573236,0.7475473519542677
3072,"Beats, Rhymes & Life: The Travels of A Tribe Called Quest",1200326,1200326,0,movies-2011.csv,2011,1.0,0.0
3073,Phantom,1197759,1034589,163170,movies-2013.csv,2013,0.8637705915797752,0.13622940842022477
3074,Spirited Away 2017 Re-release,1196791,1196791,0,movies-2017.csv,2017,1.0,0.0
3075,The Captain,1196669,109226,1087443,movies-2018.csv,2018,0.09127503094005109,0.9087249690599489
3076,Great Performances at the Met: Saint-Saëns: Samson et Dalila,1195758,1195758,0,movies-2018.csv,2018,1.0,0.0
3077,Repentance,1194961,1189612,5349,movies-2014.csv,2014,0.9955237032840403,0.0044762967159597674
3078,The First Grader,1194710,332000,862710,movies-2011.csv,2011,0.27789170593700563,0.7221082940629944
3079,Free Men,1192651,53810,1138841,movies-2011.csv,2011,0.04511797667549015,0.9548820233245099
3080,Kingdom Men Rising,1188936,1188936,0,movies-2019.csv,2019,1.0,0.0
3081,Shubh Mangal Savdhan,1188541,689874,498667,movies-2017.csv,2017,0.5804376963016,0.4195623036984
3082,Kill the Irishman,1188194,1188194,0,movies-2011.csv,2011,1.0,0.0
3083,Dead Snow 2: Red vs. Dead,1187477,37473,1150004,movies-2014.csv,2014,0.03155682173212618,0.9684431782678738
3084,Los Domirriqueños 2,1187280,1187280,0,movies-2019.csv,2019,1.0,0.0
3085,Savage,1183965,0,1183965,movies-2020.csv,2020,0.0,1.0
3086,Remember 2016 Re-release,1181023,637555,543468,movies-2016.csv,2016,0.5398328398346179,0.46016716016538206
3087,Fire at Sea,1178377,120933,1057444,movies-2016.csv,2016,0.10262674848541681,0.8973732515145832
3088,Any Body Can Dance 2,1176958,892133,284825,movies-2015.csv,2015,0.7579990110097387,0.24200098899026135
3089,Marie's Story,1173514,11720,1161794,movies-2014.csv,2014,0.009987098577434952,0.990012901422565
3090,Raanjhanaa,1171761,903232,268529,movies-2013.csv,2013,0.7708329599636786,0.2291670400363214
3091,The Innkeepers,1169750,78396,1091354,movies-2012.csv,2012,0.06701944860012823,0.9329805513998718
3092,Dark Tide,1167612,0,1167612,movies-2012.csv,2012,0.0,1.0
3093,Great Performances at the Met: Verdi: Luisa Miller,1166858,1166858,0,movies-2018.csv,2018,1.0,0.0
3094,Her & Him,1166781,857986,308795,movies-2016.csv,2016,0.7353445076668201,0.2646554923331799
3095,You Ain't Seen Nothin' Yet,1166740,18929,1147811,movies-2012.csv,2012,0.01622383735879459,0.9837761626412054
3096,Vaxxed: From Cover-Up to Catastrophe,1163265,1163265,0,movies-2016.csv,2016,1.0,0.0
3097,Louder Than Bombs,1160724,163807,996917,movies-2015.csv,2015,0.14112484966279668,0.8588751503372033
3098,Where Hope Grows,1159072,1156000,3072,movies-2015.csv,2015,0.9973496038209878,0.002650396179012175
3099,Breathe,1158695,42297,1116398,movies-2014.csv,2014,0.03650399803226906,0.9634960019677309
3100,Darling Companion,1157257,793815,363442,movies-2012.csv,2012,0.6859452999636209,0.31405470003637914
3101,Napping Princess,1156847,48198,1108649,movies-2017.csv,2017,0.041663245009927845,0.9583367549900722
3102,Embrace: The Documentary,1155263,629126,526137,movies-2016.csv,2016,0.5445738329713667,0.4554261670286333
3103,Detective Jagga,1154862,861740,293122,movies-2017.csv,2017,0.7461843925940935,0.25381560740590653
3104,Step,1152839,1146292,6547,movies-2017.csv,2017,0.9943209763028489,0.00567902369715112
3105,Liberal Arts,1150681,327345,823336,movies-2012.csv,2012,0.28447936482830605,0.715520635171694
3106,Cartel Land,1145923,704352,441571,movies-2015.csv,2015,0.6146591001315097,0.3853408998684903
3107,National Theatre Live: King Lear,1142561,185305,957256,movies-2018.csv,2018,0.16218390090332158,0.8378160990966784
3108,Roma,1140769,0,1140769,movies-2018.csv,2018,0.0,1.0
3109,The Song of Names,1138962,1077584,61378,movies-2019.csv,2019,0.9461105813890192,0.05388941861098088
3110,The Hollars,1138609,1016985,121624,movies-2016.csv,2016,0.8931819439333433,0.10681805606665677
3111,Fathom Premieres 6 Below: Miracle on the Mountain,1135531,14838,1120693,movies-2017.csv,2017,0.01306701446283721,0.9869329855371628
3112,Cell,1133031,0,1133031,movies-2016.csv,2016,0.0,1.0
3113,Dancer,1131649,71917,1059732,movies-2016.csv,2016,0.06355062391253825,0.9364493760874617
3114,Stranger by the Lake,1131241,325196,806045,movies-2013.csv,2013,0.2874683643891974,0.7125316356108027
3115,Weekend,1128477,484592,643885,movies-2011.csv,2011,0.4294212465118917,0.5705787534881083
3116,In the Name Of,1127938,9883,1118055,movies-2013.csv,2013,0.008762006422338816,0.9912379935776612
3117,Look Away,1119537,0,1119537,movies-2018.csv,2018,0.0,1.0
3118,Papa Hemingway in Cuba,1117399,1115615,1784,movies-2016.csv,2016,0.9984034351203106,0.00159656487968935
3119,The Mill and the Cross,1116180,312187,803993,movies-2011.csv,2011,0.2796923435288215,0.7203076564711784
3120,Great Performances at the Met: Donizetti: L'Elisir d'Amore,1115018,1115018,0,movies-2018.csv,2018,1.0,0.0
3121,A War,1114663,122902,991761,movies-2015.csv,2015,0.11025933398704361,0.8897406660129564
3122,The Selfish Giant,1114027,12189,1101838,movies-2013.csv,2013,0.01094138651935725,0.9890586134806427
3123,Walking with the Enemy,1112592,1112592,0,movies-2014.csv,2014,1.0,0.0
3124,The Overnight,1110522,1110522,0,movies-2015.csv,2015,1.0,0.0
3125,My Neighbor Totoro 2019 Re-release,1105564,1105564,0,movies-2019.csv,2019,1.0,0.0
3126,"Peace, Love & Misunderstanding",1105020,590700,514320,movies-2012.csv,2012,0.5345604604441548,0.46543953955584516
3127,The Heart Specialist,1103037,1103037,0,movies-2011.csv,2011,1.0,0.0
3128,The Insanity of God,1102525,1102525,0,movies-2016.csv,2016,1.0,0.0
3129,El Coyote,1101470,1101470,0,movies-2019.csv,2019,1.0,0.0
3130,Beyond the Reach,1100432,45895,1054537,movies-2015.csv,2015,0.04170634805240124,0.9582936519475987
3131,Kajillionaire,1100341,531430,568911,movies-2020.csv,2020,0.48296846159508733,0.5170315384049127
3132,Columbus,1093077,1017107,75970,movies-2017.csv,2017,0.9304989492963441,0.06950105070365582
3133,Northern Soul,1092359,8886,1083473,movies-2014.csv,2014,0.008134688321330259,0.9918653116786698
3134,Bombshell: The Hedy Lamarr Story,1092277,820300,271977,movies-2017.csv,2017,0.7509999752809956,0.24900002471900443
3135,The Son of No One,1091132,30680,1060452,movies-2011.csv,2011,0.028117587972857547,0.9718824120271424
3136,The Goonies 2019 Re-release,1089463,864378,225085,movies-2019.csv,2019,0.7933982154510983,0.2066017845489016
3137,The Sky Is Pink,1088641,652592,436049,movies-2019.csv,2019,0.5994556515876216,0.40054434841237835
3138,Misbehaviour,1087755,0,1087755,movies-2020.csv,2020,0.0,1.0
3139,Sunset,1083299,164906,918393,movies-2018.csv,2018,0.15222574746215034,0.8477742525378497
3140,Jesus Is King,1082629,973000,109629,movies-2019.csv,2019,0.8987381642280042,0.10126183577199577
3141,Mystify: Michael Hutchence,1082456,289573,792883,movies-2019.csv,2019,0.2675147996777698,0.7324852003222302
3142,Page One: Inside the New York Times,1077982,1067028,10954,movies-2011.csv,2011,0.9898384203075747,0.010161579692425291
3143,Merci pour tout,1073969,1073969,0,movies-2019.csv,2019,1.0,0.0
3144,The First Monday in May,1072943,527474,545469,movies-2016.csv,2016,0.4916141864013279,0.5083858135986721
3145,Killing Season,1071322,39881,1031441,movies-2013.csv,2013,0.03722596940975729,0.9627740305902427
3146,Chal Mera Putt 2,1070997,445000,625997,movies-2020.csv,2020,0.4155006970140906,0.5844993029859094
3147,Love and Monsters,1070714,1070714,0,movies-2020.csv,2020,1.0,0.0
3148,Au nom de ma fille,1066493,1623,1064870,movies-2016.csv,2016,0.001521810269734541,0.9984781897302655
3149,The Oogieloves in the Big Balloon Adventure,1065907,1065907,0,movies-2012.csv,2012,1.0,0.0
3150,50 to 1,1064454,1064454,0,movies-2014.csv,2014,1.0,0.0
3151,Dangerous Ishq,1062825,0,1062825,movies-2012.csv,2012,0.0,1.0
3152,Hope Gap,1056908,104732,952176,movies-2020.csv,2020,0.0990928254871758,0.9009071745128242
3153,Bennett's War,1056416,1056416,0,movies-2019.csv,2019,1.0,0.0
3154,The Tax Collector,1055718,942666,113052,movies-2020.csv,2020,0.8929145851448966,0.10708541485510335
3155,Borgman,1052010,57474,994536,movies-2013.csv,2013,0.05463256052699119,0.9453674394730088
3156,No One Lives,1048704,74918,973786,movies-2013.csv,2013,0.07143865189796167,0.9285613481020383
3157,Princess Mononoke 2019 Re-release,1046446,1046446,0,movies-2019.csv,2019,1.0,0.0
3158,Becky,1045873,1003700,42173,movies-2020.csv,2020,0.9596767485153551,0.040323251484644884
3159,A Brilliant Young Mind,1043620,171793,871827,movies-2015.csv,2015,0.16461259845537649,0.8353874015446235
3160,Made In Mexico,1042673,151133,891540,movies-2012.csv,2012,0.14494764897527795,0.855052351024722
3161,Spark: A Space Tail,1040689,196458,844231,movies-2017.csv,2017,0.18877685840822764,0.8112231415917723
3162,Befikre,1040421,498000,542421,movies-2016.csv,2016,0.4786523916760619,0.5213476083239381
3163,The Dark Crystal 2018 Re-release,1036956,1036956,0,movies-2018.csv,2018,1.0,0.0
3164,Noah,1035603,1035603,0,movies-2019.csv,2019,1.0,0.0
3165,The Last Shift,1035128,1034467,661,movies-2020.csv,2020,0.9993614316297115,0.0006385683702885054
3166,Unconditional,1034448,1005800,28648,movies-2012.csv,2012,0.9723060028150279,0.02769399718497208
3167,Ain't Them Bodies Saints,1031243,396519,634724,movies-2013.csv,2013,0.38450588270659775,0.6154941172934022
3168,Knight of Cups,1026288,566006,460282,movies-2015.csv,2015,0.5515079587796018,0.44849204122039815
3169,Casablanca 2017 Re-release,1024560,1024560,0,movies-2017.csv,2017,1.0,0.0
3170,Tangerines,1024132,144501,879631,movies-2015.csv,2015,0.14109606964727203,0.8589039303527279
3171,Color Out of Space,1023510,765561,257949,movies-2020.csv,2020,0.7479760823050092,0.2520239176949908
3172,Great Performances at the Met: Puccini: La Fanciulla del West,1023233,1023233,0,movies-2018.csv,2018,1.0,0.0
3173,Husband Material,1016545,567417,449128,movies-2018.csv,2018,0.5581818807824543,0.4418181192175457
3174,Big Stone Gap,1012804,1009301,3503,movies-2015.csv,2015,0.9965412853819693,0.0034587146180307345
3175,Transit,1012747,815290,197457,movies-2018.csv,2018,0.8050283042062825,0.19497169579371748
3176,L'attesa,1010766,55804,954962,movies-2015.csv,2015,0.05520961330317799,0.944790386696822
3177,Elvis: The Comeback Special,1010657,1010657,0,movies-2018.csv,2018,1.0,0.0
3178,Far from Men,1010485,5336,1005149,movies-2015.csv,2015,0.0052806325675294535,0.9947193674324706
3179,Cold Blood,1009888,5083,1004805,movies-2019.csv,2019,0.005033231407839285,0.9949667685921607
3180,The Song,1009620,1009620,0,movies-2014.csv,2014,1.0,0.0
3181,Francofonia,1008154,307040,701114,movies-2015.csv,2015,0.3045566451157264,0.6954433548842737
3182,Sidewalls,1008116,2377,1005739,movies-2011.csv,2011,0.0023578635791912834,0.9976421364208087
3183,Ghost House,1004155,0,1004155,movies-2017.csv,2017,0.0,1.0
3184,Faith of Our Fathers,1004105,1004105,0,movies-2015.csv,2015,1.0,0.0
3185,Kiki's Delivery Service 2019 Re-release,1004057,1004057,0,movies-2019.csv,2019,1.0,0.0
3186,"Polina, danser sa vie",1000474,165203,835271,movies-2016.csv,2016,0.16512473087756405,0.8348752691224359
3187,The Workshop,1000056,22061,977995,movies-2017.csv,2017,0.022059764653179423,0.9779402353468206
3188,Gabbar is Back,998582,534601,463981,movies-2015.csv,2015,0.5353601406794835,0.4646398593205165
3189,National Theatre Live: Antony & Cleopatra,998079,83672,914407,movies-2018.csv,2018,0.08383304327613346,0.9161669567238665
3190,Photograph,996171,344534,651637,movies-2019.csv,2019,0.34585829139776203,0.654141708602238
3191,Burn,996103,996103,0,movies-2012.csv,2012,1.0,0.0
3192,Long Live Freedom 2014 Re-release,995990,48541,947449,movies-2014.csv,2014,0.04873643309671784,0.9512635669032822
3193,Child's Pose,994126,97170,896956,movies-2013.csv,2013,0.09774414913200137,0.9022558508679986
3194,Labyrinth 2018 Re-release,993336,993336,0,movies-2013.csv,2013,1.0,0.0
3195,Blue Ruin,993313,258384,734929,movies-2014.csv,2014,0.2601234454799243,0.7398765545200757
3196,Beyond Skyline,992181,0,992181,movies-2017.csv,2017,0.0,1.0
3197,Blackthorn,987883,200558,787325,movies-2011.csv,2011,0.20301796872706585,0.7969820312729341
3198,American Masters: Miles Davis: Birth of the Cool,984499,614201,370298,movies-2019.csv,2019,0.6238716342017615,0.3761283657982385
3199,Being Flynn,983124,540152,442972,movies-2012.csv,2012,0.5494240807873676,0.4505759192126324
3200,Schindler's List 2018 Re-release,981489,833050,148439,movies-2018.csv,2018,0.8487614226955167,0.15123857730448328
3201,Mr. Pip,977855,1714,976141,movies-2013.csv,2013,0.0017528161128183626,0.9982471838871816
3202,Stuck in Love.,977671,81071,896600,movies-2013.csv,2013,0.08292257824973841,0.9170774217502616
3203,Journey's End,970809,161796,809013,movies-2018.csv,2018,0.166661001288616,0.8333389987113841
3204,The Irishman,968853,0,968853,movies-2019.csv,2019,0.0,1.0
3205,Trishna,967672,240381,727291,movies-2012.csv,2012,0.24841165188204267,0.7515883481179573
3206,Ryuichi Sakamoto: Coda,962850,117460,845390,movies-2018.csv,2018,0.12199200290803344,0.8780079970919665
3207,Rush: Cinema Strangiato 2019,960073,960073,0,movies-2019.csv,2019,1.0,0.0
3208,A Prayer Before Dawn,958883,14453,944430,movies-2018.csv,2018,0.015072746101453462,0.9849272538985465
3209,The Endless,956425,272020,684405,movies-2018.csv,2018,0.2844133099824869,0.7155866900175132
3210,The Fighting Preacher,954641,954641,0,movies-2019.csv,2019,1.0,0.0
3211,The Catcher Was a Spy,953953,725223,228730,movies-2018.csv,2018,0.7602292775430236,0.2397707224569764
3212,The Farewell Party,951531,172860,778671,movies-2015.csv,2015,0.1816651270426292,0.8183348729573708
3213,Gimme Danger,950040,440627,509413,movies-2016.csv,2016,0.4637983663845733,0.5362016336154267
3214,Under the Tree,944991,67596,877395,movies-2017.csv,2017,0.07153083997625374,0.9284691600237462
3215,The Dinner,944808,7282,937526,movies-2014.csv,2014,0.0077073860509225154,0.9922926139490775
3216,Rebel in the Rye,944370,378294,566076,movies-2017.csv,2017,0.4005781632199244,0.5994218367800757
3217,Dark Horse 2016 Re-release,944061,940715,3346,movies-2016.csv,2016,0.9964557375000133,0.0035442624999867593
3218,Afterimage,943029,33443,909586,movies-2017.csv,2017,0.03546338447704153,0.9645366155229584
3219,The Road,942041,92476,849565,movies-2011.csv,2011,0.0981655787805414,0.9018344212194586
3220,Landline,940854,940854,0,movies-2017.csv,2017,1.0,0.0
3221,Becoming Astrid,938766,120486,818280,movies-2018.csv,2018,0.12834508280018664,0.8716549171998134
3222,Revenge,938055,102091,835964,movies-2018.csv,2018,0.10883263774512156,0.8911673622548785
3223,The Vigil,935484,0,935484,movies-2020.csv,2020,0.0,1.0
3224,Kaili Blues,935236,32164,903072,movies-2016.csv,2016,0.034391319410287884,0.9656086805897122
3225,Barely Lethal,933847,6075,927772,movies-2015.csv,2015,0.006505348306521304,0.9934946516934787
3226,Perfect Sense,933352,2959,930393,movies-2011.csv,2011,0.0031702937369824033,0.9968297062630176
3227,A Borrowed Identity,930958,281540,649418,movies-2015.csv,2015,0.30241965802968557,0.6975803419703145
3228,White Christmas 2018 Re-release,928298,928298,0,movies-2018.csv,2018,1.0,0.0
3229,Like Arrows,928265,817990,110275,movies-2018.csv,2018,0.8812031047168642,0.11879689528313574
3230,Toni Morrison: The Pieces I Am,927495,903018,24477,movies-2019.csv,2019,0.9736095612375268,0.026390438762473115
3231,How I Live Now,925762,60213,865549,movies-2013.csv,2013,0.06504155495688957,0.9349584450431104
3232,Patterns of Evidence: Exodus,925576,925576,0,movies-2015.csv,2015,1.0,0.0
3233,Gentleman,923884,897876,26008,movies-2016.csv,2016,0.9718492797797126,0.028150720220287397
3234,ATM,921752,3010,918742,movies-2012.csv,2012,0.003265520443676824,0.9967344795563232
3235,Paradise,921242,14873,906369,movies-2017.csv,2017,0.01614450926032465,0.9838554907396754
3236,Riverdance 25th Anniversary Show,920607,81879,838728,movies-2020.csv,2020,0.08894023182530657,0.9110597681746935
3237,Palo Alto,919591,767732,151859,movies-2014.csv,2014,0.8348624551566947,0.16513754484330534
3238,Back to 1942,918487,312954,605533,movies-2012.csv,2012,0.3407277402946367,0.6592722597053633
3239,Kirk Cameron: Connect,918127,918127,0,movies-2018.csv,2018,1.0,0.0
3240,The Lodgers,916727,7362,909365,movies-2018.csv,2018,0.00803074415829358,0.9919692558417064
3241,Kings,910269,274635,635634,movies-2018.csv,2018,0.3017075172284237,0.6982924827715763
3242,Seymour: An Introduction,907742,743541,164201,movies-2015.csv,2015,0.8191104961541936,0.1808895038458064
3243,Sholem Aleichem: Laughing in the Darkness,906666,906666,0,movies-2011.csv,2011,1.0,0.0
3244,The Dead Lands,906158,5240,900918,movies-2014.csv,2014,0.0057826560048026944,0.9942173439951973
3245,Bitter Harvest,904399,557241,347158,movies-2017.csv,2017,0.6161450864054472,0.38385491359455287
3246,Generation Iron,901649,849521,52128,movies-2013.csv,2013,0.9421859282270595,0.05781407177294047
3247,The Game Changers,897992,739711,158281,movies-2019.csv,2019,0.8237389642669423,0.17626103573305776
3248,A Woman's Life,895944,37626,858318,movies-2016.csv,2016,0.04199592831694838,0.9580040716830516
3249,You're Not You,894964,11486,883478,movies-2014.csv,2014,0.01283403578244488,0.9871659642175551
3250,Best of Enemies: Buckley vs. Vidal,892802,892802,0,movies-2015.csv,2015,1.0,0.0
3251,Believe,890303,890303,0,movies-2016.csv,2016,1.0,0.0
3252,Mafia Inc,889863,889863,0,movies-2020.csv,2020,1.0,0.0
3253,Alone Yet Not Alone,887851,887851,0,movies-2013.csv,2013,1.0,0.0
3254,The Future,887172,568662,318510,movies-2011.csv,2011,0.6409828082942203,0.3590171917057797
3255,The Nightingale,885916,400209,485707,movies-2019.csv,2019,0.4517459894617548,0.5482540105382452
3256,Always Kabhi Kabhi,884624,21381,863243,movies-2011.csv,2011,0.024169590696160176,0.9758304093038398
3257,Ai Weiwei: Never Sorry,881661,534100,347561,movies-2012.csv,2012,0.6057883925908031,0.394211607409197
3258,The Hummingbird Project,876980,371784,505196,movies-2019.csv,2019,0.423936691828776,0.576063308171224
3259,Between Me and My Mind,875191,875191,0,movies-2019.csv,2019,1.0,0.0
3260,The Polar Express 2017 IMAX Release,875150,875150,0,movies-2017.csv,2017,1.0,0.0
3261,Particle Fever,869838,869838,0,movies-2014.csv,2014,1.0,0.0
3262,Bird People,866211,32111,834100,movies-2014.csv,2014,0.037070644450370636,0.9629293555496293
3263,Howl's Moving Castle 2019 Re-release,865647,865647,0,movies-2019.csv,2019,1.0,0.0
3264,Great Performances at the Met: Nico Muhly: Marnie,865551,849710,15841,movies-2018.csv,2018,0.981698363239139,0.018301636760861002
3265,Cut Throat City,864928,855894,9034,movies-2020.csv,2020,0.9895551999704022,0.010444800029597839
3266,Love,861057,249083,611974,movies-2015.csv,2015,0.2892758551408327,0.7107241448591672
3267,Highway,858783,529136,329647,movies-2014.csv,2014,0.6161463373168775,0.3838536626831225
3268,Night Moves,858513,271755,586758,movies-2014.csv,2014,0.3165415083988245,0.6834584916011756
3269,Steel Magnolias 2019 Re-release,855421,855421,0,movies-2019.csv,2019,1.0,0.0
3270,A Touch of Sin,854891,154120,700771,movies-2013.csv,2013,0.18028029304320667,0.8197197069567933
3271,Happythankyoumoreplease,853862,216110,637752,movies-2011.csv,2011,0.2530971046843635,0.7469028953156365
3272,The Sea of Trees,850985,20444,830541,movies-2016.csv,2016,0.02402392521607314,0.9759760747839269
3273,31,850419,779820,70599,movies-2016.csv,2016,0.9169832753031153,0.08301672469688472
3274,Wilson,848646,653951,194695,movies-2017.csv,2017,0.7705816088215817,0.22941839117841833
3275,Atlas Shrugged: Who Is John Galt?,846704,846704,0,movies-2014.csv,2014,1.0,0.0
3276,The Polar Express 2015 IMAX Release,846602,846602,0,movies-2015.csv,2015,1.0,0.0
3277,Lizzie,844786,642157,202629,movies-2018.csv,2018,0.7601416216651318,0.23985837833486823
3278,Higher Ground 2011 Re-release,843370,841733,1637,movies-2011.csv,2011,0.9980589776729075,0.001941022327092498
3279,Gunday,843232,0,843232,movies-2014.csv,2014,0.0,1.0
3280,Mary Kom,839840,621300,218540,movies-2014.csv,2014,0.739783768336826,0.2602162316631739
3281,BANDSTAND: The Broadway Musical on Screen,839554,839554,0,movies-2018.csv,2018,1.0,0.0
3282,Hôtel Normandy,836709,4640,832069,movies-2013.csv,2013,0.005545536142195196,0.9944544638578048
3283,Khiladi 786,835095,379466,455629,movies-2012.csv,2012,0.4543986013567319,0.5456013986432682
3284,The Exception,834572,708973,125599,movies-2017.csv,2017,0.8495048959227005,0.1504951040772995
3285,Premam,834525,828278,6247,movies-2016.csv,2016,0.9925143045445014,0.007485695455498637
3286,Children's Party,832150,6330,825820,movies-2011.csv,2011,0.0076068016583548635,0.9923931983416452
3287,Byzantium,828284,89237,739047,movies-2013.csv,2013,0.10773720124981287,0.8922627987501871
3288,Detective Byomkesh Bakshy!,827437,579055,248382,movies-2015.csv,2015,0.6998176296201403,0.30018237037985973
3289,13 Sins,826913,13809,813104,movies-2014.csv,2014,0.01669945931434141,0.9833005406856586
3290,Gekijouban K: Missing Kings,826323,33531,792792,movies-2014.csv,2014,0.04057856310425826,0.9594214368957418
3291,Inside,824414,0,824414,movies-2017.csv,2017,0.0,1.0
3292,Que Leones,822828,822828,0,movies-2019.csv,2019,1.0,0.0
3293,The Nest,820520,137886,682634,movies-2020.csv,2020,0.16804709208794424,0.8319529079120558
3294,The Lord of the Rings: The Return of the King 2011 Re-release,818580,818580,0,movies-2011.csv,2011,1.0,0.0
3295,Babyteeth,817712,4507,813205,movies-2020.csv,2020,0.005511720507953901,0.9944882794920461
3296,Possessor,816145,752885,63260,movies-2020.csv,2020,0.922489263549982,0.07751073645001808
3297,Life Itself,815645,810454,5191,movies-2014.csv,2014,0.9936357116147343,0.0063642883852656484
3298,Saw 10th Anniversary Release,815324,815324,0,movies-2014.csv,2014,1.0,0.0
3299,Tangerine,814868,702354,112514,movies-2015.csv,2015,0.861923648983639,0.13807635101636093
3300,Age of Uprising: The Legend of Michael Kohlhaas,813550,3313,810237,movies-2013.csv,2013,0.004072275828160531,0.9959277241718395
3301,The Heiresses,811196,78473,732723,movies-2018.csv,2018,0.09673740994778081,0.9032625900522192
3302,Bangistan,810419,48694,761725,movies-2015.csv,2015,0.06008496839289306,0.939915031607107
3303,Bill W.,809590,809590,0,movies-2012.csv,2012,1.0,0.0
3304,Joni 75: A Birthday Celebration,808831,752205,56626,movies-2019.csv,2019,0.9299903193621412,0.07000968063785884
3305,The Whistlers,808743,55608,753135,movies-2019.csv,2019,0.06875855494267029,0.9312414450573298
3306,Breathing,807436,4630,802806,movies-2011.csv,2011,0.005734200605373057,0.9942657993946269
3307,V/H/S/2,805574,21833,783741,movies-2013.csv,2013,0.027102413930936202,0.9728975860690638
3308,The Wrecking Crew!,801606,801606,0,movies-2015.csv,2015,1.0,0.0
3309,Red Army,798680,694600,104080,movies-2015.csv,2015,0.8696849802173586,0.13031501978264134
3310,Wakefield,798214,262599,535615,movies-2017.csv,2017,0.32898320500517403,0.6710167949948259
3311,Vita & Virginia,793439,42741,750698,movies-2019.csv,2019,0.05386803522387985,0.9461319647761202
3312,Shortcut,793084,793084,0,movies-2020.csv,2020,1.0,0.0
3313,Tickled,790519,613956,176563,movies-2016.csv,2016,0.7766492645970559,0.22335073540294414
3314,Thin Ice,790421,790421,0,movies-2012.csv,2012,1.0,0.0
3315,Lootera,789671,581813,207858,movies-2013.csv,2013,0.7367789877050063,0.26322101229499373
3316,Momentum,789406,0,789406,movies-2015.csv,2015,0.0,1.0
3317,Chonda Pierce: Unashamed,787979,787979,0,movies-2019.csv,2019,1.0,0.0
3318,Elf 2019 Re-release,786249,786249,0,movies-2019.csv,2019,1.0,0.0
3319,George Takei's Allegiance,784850,784850,0,movies-2017.csv,2017,1.0,0.0
3320,The Paris Opera,781039,55482,725557,movies-2017.csv,2017,0.07103614544216102,0.928963854557839
3321,Futuro Beach,779835,20262,759573,movies-2014.csv,2014,0.025982419357941103,0.9740175806420589
3322,Mrs. Hyde,778142,18627,759515,movies-2018.csv,2018,0.023937790274782753,0.9760622097252173
3323,Ordinary Love,774877,323688,451189,movies-2019.csv,2019,0.41772823299697887,0.5822717670030211
3324,The D Train,774780,673151,101629,movies-2015.csv,2015,0.8688285706910349,0.13117142930896514
3325,The Church,772000,772000,0,movies-2019.csv,2019,1.0,0.0
3326,Grand Masti,770535,413903,356632,movies-2013.csv,2013,0.5371631398963058,0.4628368601036942
3327,Pariah,769552,769552,0,movies-2011.csv,2011,1.0,0.0
3328,The Lord of the Rings: The Fellowship of the Ring 2011 Re-release,768580,768580,0,movies-2011.csv,2011,1.0,0.0
3329,Theeb,768449,283024,485425,movies-2015.csv,2015,0.3683055088886836,0.6316944911113165
3330,Yalom's Cure,766974,1164,765810,movies-2014.csv,2014,0.0015176524888718523,0.9984823475111282
3331,Lo and Behold: Reveries of the Connected World,765796,594912,170884,movies-2016.csv,2016,0.7768544103129293,0.2231455896870707
3332,DanTDM Presents The Contest,765363,307484,457879,movies-2019.csv,2019,0.4017492353301636,0.5982507646698364
3333,Patterns of Evidence: Moses Controversy,765361,765361,0,movies-2019.csv,2019,1.0,0.0
3334,The Polar Express 2016 IMAX Release,765154,765154,0,movies-2016.csv,2016,1.0,0.0
3335,The Lord of the Rings: The Two Towers 2011 Re-release,764607,764607,0,movies-2011.csv,2011,1.0,0.0
3336,Kahlil Gibran's The Prophet,764498,355343,409155,movies-2015.csv,2015,0.4648056633241683,0.5351943366758317
3337,The Invisibles,764250,407373,356877,movies-2018.csv,2018,0.5330363101079489,0.466963689892051
3338,Pick of the Litter,763688,578717,184971,movies-2018.csv,2018,0.7577924492724778,0.24220755072752223
3339,Museo,762284,148505,613779,movies-2018.csv,2018,0.19481584291418946,0.8051841570858106
3340,The Shining 2017 Re-release,760309,421572,338737,movies-2017.csv,2017,0.5544745623161109,0.445525437683889
3341,Bombay Velvet,758478,450692,307786,movies-2015.csv,2015,0.59420576470247,0.40579423529753006
3342,Jaws 2020 Re-release,758367,758300,67,movies-2020.csv,2020,0.999911652273899,8.834772610095112e-05
3343,Boundaries,755977,703438,52539,movies-2018.csv,2018,0.9305018538923803,0.06949814610761967
3344,I Love Lucy: A Colorized Celebration,754323,754323,0,movies-2019.csv,2019,1.0,0.0
3345,Elsa & Fred,753975,285863,468112,movies-2014.csv,2014,0.37914121821015284,0.6208587817898471
3346,Tommy's Honour,751345,569306,182039,movies-2017.csv,2017,0.7577158296122287,0.24228417038777125
3347,A Five Star Life 2014 Re-release,749653,306917,442736,movies-2014.csv,2014,0.4094120879927113,0.5905879120072887
3348,Everybody's Everything,748539,547207,201332,movies-2019.csv,2019,0.731033386369982,0.26896661363001795
3349,Hobo with a Shotgun,748453,703372,45081,movies-2011.csv,2011,0.9397677609682906,0.060232239031709406
3350,Arthur Newman,747140,207853,539287,movies-2013.csv,2013,0.27819819578659954,0.7218018042134005
3351,Saturday's Warrior,744046,744046,0,movies-2016.csv,2016,1.0,0.0
3352,Palm Springs,741554,164000,577554,movies-2020.csv,2020,0.2211571915194308,0.7788428084805692
3353,"Kumiko, The Treasure Hunter",739623,623383,116240,movies-2015.csv,2015,0.8428388516852504,0.15716114831474953
3354,Forks Over Knives,739561,739561,0,movies-2011.csv,2011,1.0,0.0
3355,Vicky Donor,739085,549001,190084,movies-2012.csv,2012,0.7428117198968995,0.25718828010310046
3356,Ramen Shop,735008,88455,646553,movies-2018.csv,2018,0.12034562889111411,0.8796543711088859
3357,Wiener-Dog,734729,477453,257276,movies-2016.csv,2016,0.6498355175853955,0.35016448241460457
3358,David Crosby: Remember My Name,732793,732793,0,movies-2019.csv,2019,1.0,0.0
3359,Once I Was a Beehive,732655,732655,0,movies-2015.csv,2015,1.0,0.0
3360,Tabloid,731925,696921,35004,movies-2011.csv,2011,0.9521754278102265,0.04782457218977354
3361,The Polar Express 2018 Re-release,731018,731018,0,movies-2018.csv,2018,1.0,0.0
3362,Slaughterhouse Rulez,730762,4665,726097,movies-2018.csv,2018,0.006383747376026668,0.9936162526239734
3363,Land Ho!,727594,727594,0,movies-2014.csv,2014,1.0,0.0
3364,Peggy Guggenheim: Art Addict,727591,498428,229163,movies-2015.csv,2015,0.6850387099345648,0.3149612900654351
3365,Toy Story 2020 Re-release,727218,727000,218,movies-2020.csv,2020,0.9997002274421151,0.00029977255788498085
3366,Liz and the Blue Bird,726454,63204,663250,movies-2018.csv,2018,0.08700344412722623,0.9129965558727737
3367,"Monsters, Inc. 2020 Re-release",726000,726000,0,movies-2020.csv,2020,1.0,0.0
3368,Bullett Raja,725588,0,725588,movies-2013.csv,2013,0.0,1.0
3369,The Great Alaskan Race,725415,485603,239812,movies-2019.csv,2019,0.6694140595383332,0.3305859404616668
3370,May It Last,725286,725286,0,movies-2017.csv,2017,1.0,0.0
3371,A Tale of Love and Darkness,724885,572212,152673,movies-2015.csv,2015,0.7893831435331121,0.21061685646688785
3372,The Act of Killing,722714,486919,235795,movies-2013.csv,2013,0.6737367755432992,0.3262632244567007
3373,Where's My Roy Cohn?,722603,705274,17329,movies-2019.csv,2019,0.9760186437089245,0.023981356291075458
3374,Singham,722451,350864,371587,movies-2011.csv,2011,0.4856578508438635,0.5143421491561365
3375,12 Days,722049,5204,716845,movies-2017.csv,2017,0.007207267096831379,0.9927927329031686
3376,Effie Gray,721143,352534,368609,movies-2014.csv,2014,0.4888544990383322,0.5111455009616678
3377,Kusama: Infinity,720480,360931,359549,movies-2018.csv,2018,0.5009590828336664,0.49904091716633353
3378,Revive Us 2,718607,718607,0,movies-2017.csv,2017,1.0,0.0
3379,2001: A Space Odyssey 2014 Re-release,717744,214618,503126,movies-2014.csv,2014,0.299017476983437,0.700982523016563
3380,The Shining 2012 Re-release,715736,342749,372987,movies-2012.csv,2012,0.4788762895816335,0.5211237104183666
3381,Passion,713616,92181,621435,movies-2013.csv,2013,0.12917451402434924,0.8708254859756508
3382,Gerhard Richter Painting,713188,242646,470542,movies-2011.csv,2011,0.34022726125509684,0.6597727387449032
3383,The Addams Family 2020 Re-release,711543,678926,32617,movies-2020.csv,2020,0.9541601842755814,0.04583981572441862
3384,Shootout at Wadala,711366,369573,341793,movies-2013.csv,2013,0.5195258137161461,0.48047418628385385
3385,The Polar Express 2011 IMAX Release,711168,711168,0,movies-2011.csv,2011,1.0,0.0
3386,Extraction,710636,16775,693861,movies-2015.csv,2015,0.023605615251690037,0.97639438474831
3387,Muscle Shoals,709415,696241,13174,movies-2013.csv,2013,0.9814297695988948,0.018570230401105135
3388,Paris Countdown,708757,1055,707702,movies-2013.csv,2013,0.001488521453756365,0.9985114785462437
3389,Gori Tere Pyaar Mein!,708440,342184,366256,movies-2013.csv,2013,0.48301055841002766,0.5169894415899723
3390,HBO Boxing: Canelo Alvarez vs. Gennady Golovkin II,707875,707875,0,movies-2018.csv,2018,1.0,0.0
3391,The Lost Medallion: The Adventures of Billy Stone,705854,549632,156222,movies-2013.csv,2013,0.7786766101771755,0.22132338982282454
3392,Itzhak,704968,607290,97678,movies-2018.csv,2018,0.8614433562941864,0.1385566437058136
3393,Blaze,704955,704955,0,movies-2018.csv,2018,1.0,0.0
3394,The Shining 2019 Re-release,704716,551257,153459,movies-2019.csv,2019,0.7822399377905426,0.21776006220945743
3395,Countdown to Canelo vs. Golovkin,703396,703396,0,movies-2017.csv,2017,1.0,0.0
3396,Buena Vista Social Club: Adios,701575,123445,578130,movies-2017.csv,2017,0.1759541032676478,0.8240458967323522
3397,56 Up,701278,701278,0,movies-2013.csv,2013,1.0,0.0
3398,Our Children,700215,23203,677012,movies-2012.csv,2012,0.033136965075012674,0.9668630349249874
3399,The Greatest Movie Ever Sold,698249,638476,59773,movies-2011.csv,2011,0.914395867376824,0.08560413262317597
3400,The Shining 40th Anniversary,696858,0,696858,movies-2020.csv,2020,0.0,1.0
3401,Patterns of Evidence: The Red Sea Miracle,696191,696191,0,movies-2020.csv,2020,1.0,0.0
3402,Frankie & Alice 2014 Re-release,695876,695876,0,movies-2014.csv,2014,1.0,0.0
3403,Frankie,695680,171781,523899,movies-2019.csv,2019,0.24692531048758048,0.7530746895124195
3404,Raise Hell: The Life & Times of Molly Ivins,695327,694410,917,movies-2019.csv,2019,0.9986811960415747,0.0013188039584253164
3405,The Least of These: The Graham Staines Story,695164,607015,88149,movies-2019.csv,2019,0.8731968283743117,0.12680317162568833
3406,The Congress 2013 Re-release,695131,137815,557316,movies-2013.csv,2013,0.19825759461166312,0.8017424053883369
3407,Jim Henson's Holiday Special with Fraggle Rock and Emmet Otter,695130,695130,0,movies-2018.csv,2018,1.0,0.0
3408,The Secret Scripture,694981,0,694981,movies-2017.csv,2017,0.0,1.0
3409,In the Aisles,694586,28394,666192,movies-2018.csv,2018,0.04087902721909166,0.9591209727809084
3410,Chris Brown: Welcome To My Life,693984,693984,0,movies-2017.csv,2017,1.0,0.0
3411,Titanic 2017 Re-release,693626,691642,1984,movies-2017.csv,2017,0.997139668928212,0.0028603310717879664
3412,Ferrari Ki Sawaari,689861,434107,255754,movies-2012.csv,2012,0.6292673451608367,0.37073265483916323
3413,Romeo Akbar Walter,688719,236299,452420,movies-2019.csv,2019,0.34309929013138885,0.6569007098686112
3414,Cobain: Montage of Heck,687649,0,687649,movies-2015.csv,2015,0.0,1.0
3415,Vettai,687636,204373,483263,movies-2012.csv,2012,0.29721102443734765,0.7027889755626523
3416,Mr. Church,685780,685780,0,movies-2016.csv,2016,1.0,0.0
3417,Bethany Hamilton: Unstoppable,684078,590671,93407,movies-2019.csv,2019,0.8634556293288193,0.13654437067118078
3418,Brigsby Bear,681632,532669,148963,movies-2017.csv,2017,0.7814612576874325,0.21853874231256748
3419,"Right Now, Wrong Then",680728,24470,656258,movies-2015.csv,2015,0.035946809885886874,0.9640531901141132
3420,3 Generations,680351,155936,524415,movies-2016.csv,2016,0.2291993397525689,0.7708006602474311
3421,A Matter of Faith,680113,680113,0,movies-2014.csv,2014,1.0,0.0
3422,I Spit on Your Grave 2,678604,809,677795,movies-2013.csv,2013,0.0011921533029572474,0.9988078466970427
3423,All I See Is You,678150,217644,460506,movies-2017.csv,2017,0.32093784560937844,0.6790621543906216
3424,Baaghi,676602,438207,238395,movies-2016.csv,2016,0.6476584461766297,0.3523415538233703
3425,Tyrannosaur,676111,22321,653790,movies-2011.csv,2011,0.03301380986258173,0.9669861901374183
3426,5 to 7,674579,162685,511894,movies-2015.csv,2015,0.24116523046225868,0.7588347695377413
3427,Beyond the Hills,673493,124919,548574,movies-2012.csv,2012,0.18547928486264892,0.8145207151373511
3428,The Trump Prophecy,671198,671198,0,movies-2018.csv,2018,1.0,0.0
3429,Anna and the Apocalypse,670430,545597,124833,movies-2018.csv,2018,0.8138015900243127,0.18619840997568723
3430,The Polar Express 2012 IMAX Release,669289,669289,0,movies-2012.csv,2012,1.0,0.0
3431,Bright Days Ahead 2013 Re-release,669085,21770,647315,movies-2013.csv,2013,0.03253697213358542,0.9674630278664146
3432,The Torn Poster Let Out a Hero,669070,410526,258544,movies-2013.csv,2013,0.6135770547177425,0.38642294528225746
3433,Tai Chi 2: The Hero Rises,668484,35067,633417,movies-2012.csv,2012,0.05245750085267561,0.9475424991473244
3434,Girlfriend Boyfriend,667626,64414,603212,movies-2012.csv,2012,0.09648216216863933,0.9035178378313606
3435,A Bottle in the Gaza Sea,666011,5872,660139,movies-2012.csv,2012,0.008816671196121385,0.9911833288038786
3436,Mr. Gaga: A True Story of Love and Dance,665617,173994,491623,movies-2016.csv,2016,0.2614025783596272,0.7385974216403728
3437,Stockholm,665527,292590,372937,movies-2019.csv,2019,0.43963655869709267,0.5603634413029073
3438,The Stanford Prison Experiment,663114,660561,2553,movies-2015.csv,2015,0.9961499832607967,0.0038500167392032138
3439,City of Gold,660445,640979,19466,movies-2016.csv,2016,0.9705259332722634,0.0294740667277366
3440,Camille Claudel 1915,660355,35296,625059,movies-2013.csv,2013,0.05345003823700888,0.9465499617629911
3441,Another Happy Day,659937,8464,651473,movies-2011.csv,2011,0.012825466673333969,0.987174533326666
3442,The Woman in the Fifth,659769,113800,545969,movies-2011.csv,2011,0.1724846120384559,0.8275153879615441
3443,Dragon Ball Z: Broly - The Legendary Super Saiyan,658982,658982,0,movies-2018.csv,2018,1.0,0.0
3444,Madame Bovary,658532,44235,614297,movies-2015.csv,2015,0.06717213438375053,0.9328278656162495
3445,The Painted Bird,657261,1460,655801,movies-2019.csv,2019,0.0022213397721757414,0.9977786602278242
3446,Black Water: Abyss,656976,0,656976,movies-2020.csv,2020,0.0,1.0
3447,Terri,655802,655802,0,movies-2011.csv,2011,1.0,0.0
3448,The Patience Stone,654587,148671,505916,movies-2013.csv,2013,0.22712183407247624,0.7728781659275238
3449,Whisky Galore,653866,20991,632875,movies-2017.csv,2017,0.032102907935265025,0.967897092064735
3450,Ponyo 2018 Re-release,653072,653072,0,movies-2018.csv,2018,1.0,0.0
3451,Rascals,652756,273829,378927,movies-2011.csv,2011,0.4194967185288224,0.5805032814711776
3452,In Secret,652228,444179,208049,movies-2013.csv,2013,0.6810179875748972,0.3189820124251029
3453,Salinger,650675,583633,67042,movies-2013.csv,2013,0.8969654589464786,0.10303454105352135
3454,The Family Fang,649555,262921,386634,movies-2016.csv,2016,0.4047709585793351,0.5952290414206649
3455,Jodorowsky's Dune,647280,647280,0,movies-2014.csv,2014,1.0,0.0
3456,Storage 24,646175,72,646103,movies-2012.csv,2012,0.00011142492358881108,0.9998885750764112
3457,The Public,644740,573503,71237,movies-2019.csv,2019,0.889510500356733,0.11048949964326706
3458,Dracula 3D,643758,8139,635619,movies-2012.csv,2012,0.012642949679848638,0.9873570503201513
3459,Love and Honor,641929,19684,622245,movies-2012.csv,2012,0.030663827308004467,0.9693361726919956
3460,Marjaavaan,641154,174164,466990,movies-2019.csv,2019,0.2716414465167495,0.7283585534832505
3461,Museum Hours,639121,561457,77664,movies-2012.csv,2012,0.87848310413834,0.12151689586166
3462,Aquarela,638907,307346,331561,movies-2019.csv,2019,0.48104966763550877,0.5189503323644913
3463,Welcome to Me,636819,608852,27967,movies-2015.csv,2015,0.9560832826910001,0.04391671730899989
3464,Not Fade Away,636399,610792,25607,movies-2012.csv,2012,0.9597626646176377,0.04023733538236232
3465,Batti Gul Meter Chalu,635869,249539,386330,movies-2018.csv,2018,0.39243775054295776,0.6075622494570423
3466,The Last Lions,635325,635325,0,movies-2011.csv,2011,1.0,0.0
3467,The Burnt Orange Heresy,634806,144201,490605,movies-2020.csv,2020,0.22715758830256802,0.772842411697432
3468,A Beautiful Life,634784,66171,568613,movies-2011.csv,2011,0.10424175782628421,0.8957582421737158
3469,No One Killed Jessica,634297,440525,193772,movies-2011.csv,2011,0.6945090391409703,0.30549096085902977
3470,The Black Prince,632823,0,632823,movies-2017.csv,2017,0.0,1.0
3471,Grace Jones: Bloodlight and Bami,632394,375208,257186,movies-2017.csv,2017,0.5933136620524546,0.4066863379475454
3472,Jonah: The Musical,631154,631154,0,movies-2017.csv,2017,1.0,0.0
3473,Mermaid in Paris,630987,1988,628999,movies-2020.csv,2020,0.0031506195848725886,0.9968493804151274
3474,Shut Up and Play the Hits,629107,510334,118773,movies-2012.csv,2012,0.8112038174746108,0.18879618252538916
3475,Short Peace,628807,22862,605945,movies-2013.csv,2013,0.03635773774783042,0.9636422622521695
3476,Asako I & II,627102,25559,601543,movies-2019.csv,2019,0.04075732496467879,0.9592426750353212
3477,"Love, Gilda",626318,626318,0,movies-2018.csv,2018,1.0,0.0
3478,Sleepless Night,624913,3358,621555,movies-2011.csv,2011,0.005373547997881305,0.9946264520021187
3479,Give Me Liberty,624818,242734,382084,movies-2019.csv,2019,0.3884875275680278,0.6115124724319722
3480,The Sound of Music 2018 Re-release,624392,616171,8221,movies-2018.csv,2018,0.9868335917180233,0.013166408281976707
3481,Nancy Drew and the Hidden Staircase,623088,623088,0,movies-2019.csv,2019,1.0,0.0
3482,Dirty Dancing 2019 Re-release,622968,622968,0,movies-2019.csv,2019,1.0,0.0
3483,Range 15,621738,621738,0,movies-2016.csv,2016,1.0,0.0
3484,Ghostbusters 2020 Re-release,620883,605000,15883,movies-2020.csv,2020,0.974418690800038,0.025581309199961988
3485,Die Hard 30th Anniversary Release,620525,510241,110284,movies-2018.csv,2018,0.822273075218565,0.17772692478143506
3486,Killerman,619855,291477,328378,movies-2019.csv,2019,0.470234167668245,0.529765832331755
3487,The Transformers,619597,619597,0,movies-2018.csv,2018,1.0,0.0
3488,Nowitzki: The Perfect Shot,619517,41340,578177,movies-2014.csv,2014,0.06672940371289246,0.9332705962871075
3489,Paradise: Faith,618696,6508,612188,movies-2013.csv,2013,0.010518897810879656,0.9894811021891203
3490,Paulo Coelho's Best Story,617377,8808,608569,movies-2014.csv,2014,0.014266809421147856,0.9857331905788521
3491,The Bronze,615816,615816,0,movies-2016.csv,2016,1.0,0.0
3492,Lost River,615500,45431,570069,movies-2015.csv,2015,0.07381153533712428,0.9261884646628757
3493,"A White, White Day",614674,0,614674,movies-2019.csv,2019,0.0,1.0
3494,Omar,614444,356000,258444,movies-2013.csv,2013,0.5793855908756534,0.42061440912434656
3495,Synchronic,613405,613405,0,movies-2020.csv,2020,1.0,0.0
3496,Walking the Camino: Six Ways to Santiago,612717,612717,0,movies-2013.csv,2013,1.0,0.0
3497,The Returned,612521,0,612521,movies-2013.csv,2013,0.0,1.0
3498,In Another Country,611365,25079,586286,movies-2012.csv,2012,0.04102132114203463,0.9589786788579654
3499,True to the Game 2,610710,610710,0,movies-2020.csv,2020,1.0,0.0
3500,The Muppet Movie 2019 Re-release,610475,610475,0,movies-2019.csv,2019,1.0,0.0
3501,Project Nim,609880,411184,198696,movies-2011.csv,2011,0.6742047615924445,0.3257952384075556
3502,Alone,609543,537589,71954,movies-2020.csv,2020,0.8819541853486956,0.11804581465130434
3503,Dead Before Dawn 3D,608881,0,608881,movies-2012.csv,2012,0.0,1.0
3504,The Last Suit,608209,73548,534661,movies-2017.csv,2017,0.12092553710977641,0.8790744628902236
3505,Mr. Right,607595,34694,572901,movies-2016.csv,2016,0.057100535718694195,0.9428994642813058
3506,The Reports on Sarah and Saleem,607206,117479,489727,movies-2018.csv,2018,0.1934747021603871,0.8065252978396129
3507,Life in a Day,607169,252788,354381,movies-2011.csv,2011,0.4163387788243471,0.5836612211756529
3508,Bolshoi Ballet: The Sleeping Beauty,606872,311368,295504,movies-2019.csv,2019,0.513070301480378,0.4869296985196219
3509,Neither Wolf Nor Dog,606511,606511,0,movies-2017.csv,2017,1.0,0.0
3510,The Walking Dead: Wrath/The Walking Dead/Fear the Walking Dead: What's Your Story?/Fear the Walking Dead,605764,605764,0,movies-2018.csv,2018,1.0,0.0
3511,Summer in February,605403,1624,603779,movies-2013.csv,2013,0.0026825106581896685,0.9973174893418103
3512,The Golden Glove,604479,6160,598319,movies-2019.csv,2019,0.010190593883327626,0.9898094061166723
3513,"DCI 2019: Big, Loud & Live 16",603320,603320,0,movies-2018.csv,2018,1.0,0.0
3514,The Little Death,601162,18238,582924,movies-2014.csv,2014,0.03033791224328883,0.9696620877567111
3515,The Grateful Dead Meet-Up 2018,600554,600554,0,movies-2018.csv,2018,1.0,0.0
3516,Oh Lucy!,600145,375391,224754,movies-2018.csv,2018,0.6255005040448558,0.37449949595514415
3517,Jimi: All Is by My Side,599840,340911,258929,movies-2014.csv,2014,0.568336556415044,0.431663443584956
3518,The Fencer 2016 Re-release,599537,95952,503585,movies-2016.csv,2016,0.1600435002343475,0.8399564997656525
3519,The One I Love,596933,513447,83486,movies-2014.csv,2014,0.8601417579527351,0.13985824204726494
3520,Stevie Nicks 24 Karat Gold the Concert,596905,410265,186640,movies-2020.csv,2020,0.6873204278737822,0.3126795721262177
3521,Trust,595802,120016,475786,movies-2011.csv,2011,0.20143604754599684,0.7985639524540031
3522,Skin Trade,595268,1242,594026,movies-2015.csv,2015,0.002086455176491933,0.997913544823508
3523,Blue Like Jazz,595018,595018,0,movies-2012.csv,2012,1.0,0.0
3524,Ixcanul,594836,295157,299679,movies-2015.csv,2015,0.4961989523162687,0.5038010476837314
3525,Are You Here,594396,0,594396,movies-2014.csv,2014,0.0,1.0
3526,The Armstrong Lie,594394,383294,211100,movies-2013.csv,2013,0.644848366571668,0.35515163342833206
3527,Boss,594283,0,594283,movies-2013.csv,2013,0.0,1.0
3528,The Big Lebowski 2018 Re-release,592832,582585,10247,movies-2018.csv,2018,0.9827151705710893,0.01728482942891072
3529,The Climb,592461,143423,449038,movies-2020.csv,2020,0.24208006940541235,0.7579199305945876
3530,To Kill a Mockingbird 2019 Re-release,592237,592237,0,movies-2019.csv,2019,1.0,0.0
3531,Compliance,592116,319285,272831,movies-2012.csv,2012,0.5392271109039445,0.4607728890960555
3532,The Cure: Anniversary 1978-2018 Live in Hyde Park,591904,378405,213499,movies-2019.csv,2019,0.6393013056171271,0.3606986943828729
3533,The Wonderland,591857,50876,540981,movies-2019.csv,2019,0.08595995316436233,0.9140400468356377
3534,Storm Surfers 3D,589945,117090,472855,movies-2012.csv,2012,0.19847612913068166,0.8015238708693183
3535,Starry Starry Night,589299,10033,579266,movies-2011.csv,2011,0.01702531312627376,0.9829746868737262
3536,Thunderstruck,587211,587211,0,movies-2012.csv,2012,1.0,0.0
3537,Upstream Color,587174,444098,143076,movies-2013.csv,2013,0.7563311727017885,0.24366882729821143
3538,Seberg,585845,434702,151143,movies-2020.csv,2020,0.7420085517500363,0.25799144824996373
3539,The Black Panthers: Vanguard of the Revolution,584109,516893,67216,movies-2015.csv,2015,0.8849255875187679,0.1150744124812321
3540,Undefeated,583844,562218,21626,movies-2012.csv,2012,0.9629592836442611,0.03704071635573886
3541,Gleason,583664,583664,0,movies-2016.csv,2016,1.0,0.0
3542,The Flat,583443,471842,111601,movies-2012.csv,2012,0.8087199606473983,0.1912800393526017
3543,White God,581904,282358,299546,movies-2014.csv,2014,0.48523124089196845,0.5147687591080315
3544,Novitiate,580346,580346,0,movies-2017.csv,2017,1.0,0.0
3545,Bedeviled,579942,0,579942,movies-2017.csv,2017,0.0,1.0
3546,And Then We Danced,579574,177262,402312,movies-2019.csv,2019,0.30584877858565085,0.6941512214143492
3547,Harry & Snowman,578820,561460,17360,movies-2016.csv,2016,0.9700079472029302,0.0299920527970699
3548,Bilal: A New Breed of Hero 2018 Re-release,576805,490973,85832,movies-2018.csv,2018,0.8511940777212402,0.14880592227875972
3549,The Falling,569498,0,569498,movies-2015.csv,2015,0.0,1.0
3550,Goodbye to Language,566423,401889,164534,movies-2014.csv,2014,0.7095209763727814,0.2904790236272185
3551,Never Too Late,564892,0,564892,movies-2020.csv,2020,0.0,1.0
3552,Margaret,564864,46495,518369,movies-2011.csv,2011,0.08231184851574892,0.9176881514842511
3553,The Cat Returns 2018 Re-release,563718,563718,0,movies-2018.csv,2018,1.0,0.0
3554,Like Someone in Love,562878,239056,323822,movies-2012.csv,2012,0.4247030439988772,0.5752969560011229
3555,Beetlejuice 2018 Re-release,562613,512947,49666,movies-2018.csv,2018,0.911722622833102,0.08827737716689803
3556,The Happiest Day in the Life of Olli Maki,562537,0,562537,movies-2016.csv,2016,0.0,1.0
3557,My Fair Lady 2019 Re-release,560711,560711,0,movies-2019.csv,2019,1.0,0.0
3558,Fiddler: A Miracle of Miracles,558816,549386,9430,movies-2019.csv,2019,0.9831250357899559,0.016874964210044092
3559,The Dance of Reality,558636,293680,264956,movies-2013.csv,2013,0.5257090484680543,0.47429095153194567
3560,Forrest Gump 2014 IMAX Release,557683,557683,0,movies-2014.csv,2014,1.0,0.0
3561,Castle in the Sky 2018 Re-release,557541,523664,33877,movies-2018.csv,2018,0.9392385492726095,0.060761450727390455
3562,Rojo,557092,94757,462335,movies-2018.csv,2018,0.1700921930309536,0.8299078069690464
3563,Samaritan's Purse presents Facing Darkness,555533,555533,0,movies-2017.csv,2017,1.0,0.0
3564,Circumstance,555511,454121,101390,movies-2011.csv,2011,0.8174833621656457,0.18251663783435432
3565,Dolores,555309,555309,0,movies-2017.csv,2017,1.0,0.0
3566,Every Thing Will Be Fine,554953,9233,545720,movies-2015.csv,2015,0.01663744497281752,0.9833625550271825
3567,Endless Poetry,554706,153440,401266,movies-2016.csv,2016,0.2766149996574762,0.7233850003425238
3568,Viral,551760,0,551760,movies-2016.csv,2016,0.0,1.0
3569,Open Windows,550108,1750,548358,movies-2014.csv,2014,0.0031811935110923673,0.9968188064889076
3570,Black Panther 2020 Re-release,549774,367000,182774,movies-2020.csv,2020,0.6675470284153124,0.3324529715846875
3571,Dhadak,549628,0,549628,movies-2018.csv,2018,0.0,1.0
3572,23 Blast,549185,549185,0,movies-2014.csv,2014,1.0,0.0
3573,Followed,548608,538179,10429,movies-2020.csv,2020,0.9809900694120391,0.019009930587960803
3574,We Are X,548126,45270,502856,movies-2016.csv,2016,0.0825904992647676,0.9174095007352324
3575,Planetarium,546584,3262,543322,movies-2016.csv,2016,0.005967975645097551,0.9940320243549025
3576,A Girl Walks Home Alone at Night,546352,491910,54442,movies-2014.csv,2014,0.9003536181802209,0.0996463818197792
3577,My Generation,546183,0,546183,movies-2018.csv,2018,0.0,1.0
3578,Rudderless,546149,58293,487856,movies-2014.csv,2014,0.10673460905357329,0.8932653909464268
3579,"DCI 2019: Big, Loud & Live 16",546060,546060,0,movies-2019.csv,2019,1.0,0.0
3580,He's Out There,544674,0,544674,movies-2018.csv,2018,0.0,1.0
3581,The Day Shall Come,543993,26972,517021,movies-2019.csv,2019,0.04958152035044568,0.9504184796495543
3582,Beauty and the Beast 2020 Re-release,543260,467000,76260,movies-2020.csv,2020,0.859625225490557,0.140374774509443
3583,On Any Sunday: The Next Chapter,543044,543044,0,movies-2014.csv,2014,1.0,0.0
3584,The Club,541515,52761,488754,movies-2015.csv,2015,0.09743220409406941,0.9025677959059306
3585,Dragon Ball Z: Bardock - The Father of Goku/Dragon Ball Z: Fusion Reborn,540707,540707,0,movies-2018.csv,2018,1.0,0.0
3586,On the Way to School 2015 Re-release,540658,7424,533234,movies-2015.csv,2015,0.013731416163267722,0.9862685838367323
3587,StarDog and TurboCat,537586,80490,457096,movies-2019.csv,2019,0.1497248812283058,0.8502751187716941
3588,Grateful Dead Meet-Up 2019,537153,537153,0,movies-2019.csv,2019,1.0,0.0
3589,CatVideoFest,536566,470923,65643,movies-2019.csv,2019,0.8776609028525848,0.12233909714741523
3590,Once Were Brothers: Robbie Robertson and the Band,536534,449561,86973,movies-2020.csv,2020,0.8378984370049242,0.1621015629950758
3591,Karwaan,536525,182009,354516,movies-2018.csv,2018,0.3392367550440334,0.6607632449559666
3592,Hungry Hearts,534549,6921,527628,movies-2015.csv,2015,0.012947363104224308,0.9870526368957757
3593,What They Had,533579,260136,273443,movies-2018.csv,2018,0.4875304312950847,0.5124695687049153
3594,Creature,533235,508714,24521,movies-2011.csv,2011,0.9540146464504393,0.0459853535495607
3595,Kill Your Friends,533147,0,533147,movies-2015.csv,2015,0.0,1.0
3596,Kahaani 2,532877,350703,182174,movies-2016.csv,2016,0.6581312385409767,0.3418687614590234
3597,Margaret Atwood: Live in Cinemas,529285,93690,435595,movies-2019.csv,2019,0.177012384632098,0.822987615367902
3598,The Call,527680,515831,11849,movies-2020.csv,2020,0.9775451030927835,0.022454896907216495
3599,Willy Wonka & the Chocolate Factory 2016 Re-release,526954,526633,321,movies-2016.csv,2016,0.9993908386690299,0.0006091613309700657
3600,Only Yesterday 2016 Re-release,525958,453243,72715,movies-2016.csv,2016,0.8617475159613506,0.13825248403864948
3601,The Audience 2019 Re-release,523432,106529,416903,movies-2019.csv,2019,0.20352022803344083,0.7964797719665592
3602,Bolshoi Ballet: Carmen Suite/Petrushka,522179,207523,314656,movies-2019.csv,2019,0.39741736071347183,0.6025826392865282
3603,Sound City,521181,422853,98328,movies-2013.csv,2013,0.8113361768752123,0.18866382312478774
3604,The Spy Behind Home Plate,519525,519525,0,movies-2019.csv,2019,1.0,0.0
3605,Wild Nights with Emily,519487,519487,0,movies-2019.csv,2019,1.0,0.0
3606,Scatter My Ashes at Bergdorf's,518342,518342,0,movies-2013.csv,2013,1.0,0.0
3607,Trespass Against Us,517197,5711,511486,movies-2017.csv,2017,0.011042214088635472,0.9889577859113645
3608,Grave of the Fireflies,516962,516962,0,movies-2018.csv,2018,1.0,0.0
3609,Listen to Me Marlon,516337,425831,90506,movies-2015.csv,2015,0.824715253797423,0.175284746202577
3610,The Sandlot 2018 Re-release,516130,516130,0,movies-2018.csv,2018,1.0,0.0
3611,"Love, Wedding, Marriage",515823,1926,513897,movies-2011.csv,2011,0.003733838933122408,0.9962661610668776
3612,The Big Ugly,515399,514107,1292,movies-2020.csv,2020,0.9974932042941488,0.002506795705851195
3613,A Hard Day's Night 2014 Re-release,515005,515005,0,movies-2014.csv,2014,1.0,0.0
3614,Goodbye First Love,514913,95000,419913,movies-2011.csv,2011,0.18449718690341863,0.8155028130965813
3615,Bullitt 2018 Re-release,511350,511350,0,movies-2018.csv,2018,1.0,0.0
3616,Black Butler: Book of the Atlantic,511132,248286,262846,movies-2017.csv,2017,0.4857571038401039,0.514242896159896
3617,Monsters and Men,510967,500101,10866,movies-2018.csv,2018,0.9787344388189453,0.021265561181054746
3618,Unsullied,510957,510957,0,movies-2016.csv,2016,1.0,0.0
3619,Bol,509872,188850,321022,movies-2011.csv,2011,0.3703870775410299,0.62961292245897
3620,Saving Private Ryan 2019 Re-release,508694,508694,0,movies-2019.csv,2019,1.0,0.0
3621,Una,508169,22815,485354,movies-2017.csv,2017,0.04489648128870514,0.9551035187112948
3622,The Inevitable Defeat of Mister & Pete,506303,494608,11695,movies-2013.csv,2013,0.9769011836785482,0.02309881632145178
3623,Our Last Tango,505885,100086,405799,movies-2015.csv,2015,0.19784338337764512,0.8021566166223549
3624,Gabriel and the Mountain,505769,18415,487354,movies-2017.csv,2017,0.03640990254444223,0.9635900974555578
3625,Have a Nice Day,504003,79393,424610,movies-2018.csv,2018,0.15752485600284125,0.8424751439971587
3626,Letters From Baghdad,502941,359735,143206,movies-2017.csv,2017,0.7152628240688271,0.2847371759311728
3627,Chuck,502518,320725,181793,movies-2017.csv,2017,0.6382358442881648,0.3617641557118352
3628,Deli Man,502294,502294,0,movies-2015.csv,2015,1.0,0.0
3629,Bride Flight 2011 Re-release,501360,501360,0,movies-2011.csv,2011,1.0,0.0
3630,Synonyms,501223,206003,295220,movies-2019.csv,2019,0.411000692306618,0.5889993076933819
3631,Spell,500104,500104,0,movies-2020.csv,2020,1.0,0.0
3632,Smashed,499725,376597,123128,movies-2012.csv,2012,0.7536084846665666,0.2463915153334334
3633,Hamari Adhuri Kahani,498774,235361,263413,movies-2015.csv,2015,0.4718790474242843,0.5281209525757157
3634,Whisper of the Heart 2019 Re-release,498156,498156,0,movies-2019.csv,2019,1.0,0.0
3635,Kahlil Gibran's The Prophet 2015 Re-release,496914,370146,126768,movies-2015.csv,2015,0.7448894577331289,0.25511054226687113
3636,Felix and Meira,496714,447353,49361,movies-2015.csv,2015,0.9006249068880684,0.09937509311193161
3637,April and the Extraordinary World,495879,295488,200391,movies-2015.csv,2015,0.5958873031525836,0.4041126968474164
3638,Nausicaä of the Valley of the Wind 2019 Re-release,495770,495770,0,movies-2019.csv,2019,1.0,0.0
3639,Eden,494949,65460,429489,movies-2014.csv,2014,0.13225605062339757,0.8677439493766025
3640,Steve Jobs: The Man in the Machine,494506,494506,0,movies-2015.csv,2015,1.0,0.0
3641,Monty Python's Life of Brian 2019 Re-release,494444,161507,332937,movies-2019.csv,2019,0.32664366439879944,0.6733563356012006
3642,The Polar Express 2013 IMAX Release,493776,493776,0,movies-2013.csv,2013,1.0,0.0
3643,Two Night Stand,492332,18612,473720,movies-2014.csv,2014,0.03780375843942705,0.9621962415605729
3644,Soul on a String,491294,3669,487625,movies-2017.csv,2017,0.007468033397517576,0.9925319666024824
3645,Wolves,491154,12139,479015,movies-2014.csv,2014,0.024715262422783893,0.9752847375772161
3646,Open Grave,489812,0,489812,movies-2013.csv,2013,0.0,1.0
3647,Zama,489692,200600,289092,movies-2017.csv,2017,0.40964524639977784,0.5903547536002222
3648,What Richard Did,488327,2749,485578,movies-2012.csv,2012,0.0056294245454377905,0.9943705754545622
3649,At Any Price,487455,380594,106861,movies-2013.csv,2013,0.7807777128145162,0.21922228718548378
3650,London Fields,487420,252676,234744,movies-2018.csv,2018,0.5183948135078577,0.4816051864921423
3651,Beach Rats,486623,473771,12852,movies-2017.csv,2017,0.973589411104695,0.02641058889530499
3652,Summerland,486218,58498,427720,movies-2020.csv,2020,0.12031228790377979,0.8796877120962202
3653,Cooties,485544,60058,425486,movies-2015.csv,2015,0.12369218855551711,0.8763078114444829
3654,The Russian Five,485049,485049,0,movies-2019.csv,2019,1.0,0.0
3655,63 Up,483684,483684,0,movies-2019.csv,2019,1.0,0.0
3656,Our Little Sister 2016 Re-release,483559,467555,16004,movies-2016.csv,2016,0.9669037283971552,0.03309627160284474
3657,Lawrence of Arabia 2019 Re-release,482281,482281,0,movies-2019.csv,2019,1.0,0.0
3658,The Journey,482209,155475,326734,movies-2017.csv,2017,0.32242243508520163,0.6775775649147984
3659,I Origins,481234,336472,144762,movies-2014.csv,2014,0.6991858430617953,0.3008141569382047
3660,Breathe In,481079,89661,391418,movies-2013.csv,2013,0.1863747949920907,0.8136252050079094
3661,The Third Man 2015 Re-release,478945,449191,29754,movies-2015.csv,2015,0.9378759565294553,0.062124043470544635
3662,Brotherly Love,478595,478595,0,movies-2015.csv,2015,1.0,0.0
3663,Liam Gallagher: As It Was,477009,0,477009,movies-2019.csv,2019,0.0,1.0
3664,Heart of a Dog,476384,420813,55571,movies-2015.csv,2015,0.8833483072479345,0.11665169275206556
3665,The Babymakers,475511,7889,467622,movies-2012.csv,2012,0.016590573088740325,0.9834094269112597
3666,Gorillaz: Reject False Icons,475465,453687,21778,movies-2019.csv,2019,0.9541964182431935,0.045803581756806495
3667,The Shawshank Redemption 2019 Re-release,473776,358507,115269,movies-2019.csv,2019,0.7567014791800345,0.24329852081996556
3668,On the Job,472890,164620,308270,movies-2013.csv,2013,0.34811478356488823,0.6518852164351118
3669,Pearl Jam Twenty,471334,471334,0,movies-2011.csv,2011,1.0,0.0
3670,Darbareye Elly 2015 Re-release,470760,470760,0,movies-2015.csv,2015,1.0,0.0
3671,White Bird in a Blizzard,469701,33821,435880,movies-2014.csv,2014,0.07200538214736608,0.9279946178526339
3672,Matangi/Maya/M.I.A,469489,230808,238681,movies-2018.csv,2018,0.49161535201037726,0.5083846479896228
3673,DCI 2017 Tour Premeire,467817,467817,0,movies-2017.csv,2017,1.0,0.0
3674,Time Freak,467693,10003,457690,movies-2018.csv,2018,0.021387961761240814,0.9786120382387592
3675,Hail Satan?,467361,424284,43077,movies-2019.csv,2019,0.9078292797216713,0.09217072027832875
3676,True History of the Kelly Gang,467198,33817,433381,movies-2020.csv,2020,0.07238258725422626,0.9276174127457737
3677,Last Days in Vietnam,466114,466114,0,movies-2014.csv,2014,1.0,0.0
3678,Neighboring Sounds,465082,60255,404827,movies-2012.csv,2012,0.1295577984097428,0.8704422015902572
3679,Ghanchakkar,464803,203044,261759,movies-2013.csv,2013,0.43683883279582963,0.5631611672041704
3680,Puffs: Filmed Live Off Broadway,464483,464483,0,movies-2018.csv,2018,1.0,0.0
3681,Deepsea Challenge,462959,235659,227300,movies-2014.csv,2014,0.5090277972779447,0.4909722027220553
3682,Before We Go,462875,37151,425724,movies-2015.csv,2015,0.08026140966783689,0.9197385903321631
3683,The Bag Man,461780,56574,405206,movies-2014.csv,2014,0.12251288492355668,0.8774871150764433
3684,MFKZ,461724,229423,232301,movies-2018.csv,2018,0.4968834195320148,0.5031165804679852
3685,Scotty and the Secret History of Hollywood,461689,461689,0,movies-2018.csv,2018,1.0,0.0
3686,Bully,461405,279202,182203,movies-2012.csv,2012,0.6051126450732003,0.39488735492679966
3687,Disorder,460997,51879,409118,movies-2015.csv,2015,0.11253652409885531,0.8874634759011447
3688,The Dark Knight 2018 Re-release,460178,375589,84589,movies-2018.csv,2018,0.8161819991394634,0.18381800086053657
3689,Inside Out 2020 Re-release,460176,460000,176,movies-2020.csv,2020,0.9996175376377734,0.0003824623622266263
3690,Manglehorn,459636,143101,316535,movies-2015.csv,2015,0.3113354915628889,0.6886645084371111
3691,Christmas Jars,459462,459462,0,movies-2019.csv,2019,1.0,0.0
3692,Eric Clapton: A Life in 12 Bars,459088,0,459088,movies-2017.csv,2017,0.0,1.0
3693,South Pacific 2018 Re-release,458000,458000,0,movies-2018.csv,2018,1.0,0.0
3694,We Steal Secrets,457517,166243,291274,movies-2013.csv,2013,0.3633591757246179,0.6366408242753822
3695,Paradise: Hope,457132,6701,450431,movies-2013.csv,2013,0.014658785646159096,0.9853412143538409
3696,Staying Vertical,456271,12158,444113,movies-2016.csv,2016,0.026646444766377876,0.9733535552336221
3697,Lola Versus,455754,252603,203151,movies-2012.csv,2012,0.5542529522505563,0.4457470477494438
3698,The Gospel According to André,454550,400713,53837,movies-2018.csv,2018,0.881559784402156,0.11844021559784403
3699,Leaning Into The Wind,452372,400530,51842,movies-2018.csv,2018,0.8853996268557736,0.11460037314422643
3700,Sailor Moon R: The Movie: The Promise of the Rose,452053,452053,0,movies-2017.csv,2017,1.0,0.0
3701,The Perfect Host,450885,48764,402121,movies-2011.csv,2011,0.10815174601062355,0.8918482539893764
3702,Perfect Blue 2017 Re-release,450594,446062,4532,movies-2017.csv,2017,0.9899421652307843,0.010057834769215747
3703,Kill List,450275,29063,421212,movies-2011.csv,2011,0.06454500027760812,0.9354549997223919
3704,Pearl Jam: Let's Play Two,450273,348833,101440,movies-2017.csv,2017,0.7747144510108313,0.2252855489891688
3705,Hesher,449702,382946,66756,movies-2011.csv,2011,0.8515550297752734,0.1484449702247266
3706,17 Girls,449626,15123,434503,movies-2011.csv,2011,0.033634620773709704,0.9663653792262903
3707,The Rocket,449064,56823,392241,movies-2013.csv,2013,0.1265365293143071,0.8734634706856929
3708,Before We Vanish,448829,52087,396742,movies-2017.csv,2017,0.11605087906530104,0.8839491209346989
3709,The Sleeping Beauty,446131,29066,417065,movies-2011.csv,2011,0.06515126722868395,0.9348487327713161
3710,Cruel Intentions 2019 Re-release,445218,445218,0,movies-2019.csv,2019,1.0,0.0
3711,Charlie Countryman,443990,11650,432340,movies-2013.csv,2013,0.026239329714633212,0.9737606702853668
3712,Porco Rosso 2018 Re-release,443059,443059,0,movies-2018.csv,2018,1.0,0.0
3713,Prince Avalanche,442313,205139,237174,movies-2013.csv,2013,0.46378695629565486,0.5362130437043451
3714,Elf 2018 Re-release,442073,442073,0,movies-2018.csv,2018,1.0,0.0
3715,Bastards,439935,24525,415410,movies-2013.csv,2013,0.05574687169695523,0.9442531283030448
3716,Burden,439139,139270,299869,movies-2020.csv,2020,0.31714331908575644,0.6828566809142436
3717,Desert Dancer,438165,155271,282894,movies-2014.csv,2014,0.3543665057683749,0.6456334942316251
3718,CatVideoFest 2020,437625,437625,0,movies-2020.csv,2020,1.0,0.0
3719,My Kingdom,435759,36533,399226,movies-2011.csv,2011,0.08383762584364293,0.916162374156357
3720,We the Animals,434743,400961,33782,movies-2018.csv,2018,0.9222943210126443,0.07770567898735575
3721,What We Left Behind: Star Trek DS9,434437,382457,51980,movies-2019.csv,2019,0.8803508909231949,0.11964910907680515
3722,DCI 2018 Tour Premeire,434008,434008,0,movies-2018.csv,2018,1.0,0.0
3723,Rosenwald,433924,433924,0,movies-2015.csv,2015,1.0,0.0
3724,Bjork: Biophilia Live,433686,127754,305932,movies-2014.csv,2014,0.29457718256987775,0.7054228174301223
3725,The Sower,433112,36233,396879,movies-2018.csv,2018,0.08365734498236022,0.9163426550176398
3726,Harmony,430568,23248,407320,movies-2015.csv,2015,0.0539937942438825,0.9460062057561175
3727,Ghostbusters 2019 Re-release,430435,369612,60823,movies-2019.csv,2019,0.8586941117706506,0.1413058882293494
3728,Andy Irons: Kissed by God,430393,285933,144460,movies-2018.csv,2018,0.6643532771211428,0.3356467228788572
3729,Iron Man 2020 Re-release,430000,430000,0,movies-2020.csv,2020,1.0,0.0
3730,Go Goa Gone,429350,298457,130893,movies-2013.csv,2013,0.6951368347502038,0.30486316524979623
3731,On the Beach at Night Alone,429159,37489,391670,movies-2017.csv,2017,0.08735457021756506,0.9126454297824349
3732,Infamous,429148,429148,0,movies-2020.csv,2020,1.0,0.0
3733,Guardians of the Galaxy 2020 Re-release,428424,406000,22424,movies-2020.csv,2020,0.9476593281422142,0.052340671857785744
3734,Blackway,426491,27079,399412,movies-2016.csv,2016,0.06349254732221782,0.9365074526777821
3735,Happy Bhaag Jayegi,426345,351840,74505,movies-2016.csv,2016,0.825247158990958,0.17475284100904198
3736,Killing Sarai,425332,425332,0,movies-2019.csv,2019,1.0,0.0
3737,Vertigo 2018 Re-release,425152,394212,30940,movies-2018.csv,2018,0.9272260273972602,0.07277397260273973
3738,Sound of My Voice,424088,408015,16073,movies-2012.csv,2012,0.9620998472015242,0.037900152798475785
3739,Viva,423976,178008,245968,movies-2016.csv,2016,0.41985395399739606,0.5801460460026039
3740,God Help the Girl,423306,102757,320549,movies-2014.csv,2014,0.2427487444071192,0.7572512555928808
3741,Cirque du Soleil in Cinema: KURIOS - Cabinet of Curiosities,422760,413039,9721,movies-2018.csv,2018,0.9770058662125083,0.02299413378749172
3742,Mississippi Grind,422746,130541,292205,movies-2015.csv,2015,0.3087929868053157,0.6912070131946842
3743,Behaving Badly,422697,0,422697,movies-2014.csv,2014,0.0,1.0
3744,Ben-Hur 2019 Re-release,422622,422622,0,movies-2019.csv,2019,1.0,0.0
3745,Super,422618,327716,94902,movies-2011.csv,2011,0.7754425982802436,0.22455740171975638
3746,Settai,422247,87838,334409,movies-2013.csv,2013,0.20802516062873153,0.7919748393712684
3747,Mad Max: Fury Road 2016 Re-release,421986,421986,0,movies-2016.csv,2016,1.0,0.0
3748,She's Beautiful When She's Angry,421573,421573,0,movies-2014.csv,2014,1.0,0.0
3749,The Bounce Back,421404,321910,99494,movies-2016.csv,2016,0.7638987764710349,0.23610122352896507
3750,The Cold Blue,420177,420177,0,movies-2019.csv,2019,1.0,0.0
3751,Voiceless,419952,419952,0,movies-2016.csv,2016,1.0,0.0
3752,Frankenstein 2018 Re-release,417783,417783,0,movies-2018.csv,2018,1.0,0.0
3753,Happy Phirr Bhag Jayegi,417669,103385,314284,movies-2018.csv,2018,0.2475285453313509,0.7524714546686491
3754,Bolshoi Ballet: Le Corsaire,417152,190192,226960,movies-2019.csv,2019,0.4559297330469469,0.544070266953053
3755,Dirty Wars,416853,384473,32380,movies-2013.csv,2013,0.922322737271892,0.07767726272810799
3756,Tales of Halloween,416792,0,416792,movies-2015.csv,2015,0.0,1.0
3757,Manifesto,416389,161101,255288,movies-2017.csv,2017,0.3869002303134809,0.6130997696865191
3758,Status Update,416178,4764,411414,movies-2018.csv,2018,0.011447025071003272,0.9885529749289967
3759,Sand Storm,414698,86800,327898,movies-2016.csv,2016,0.20930894289338264,0.7906910571066174
3760,The Ottoman Lieutenant,413844,240978,172866,movies-2017.csv,2017,0.5822918780989939,0.4177081219010062
3761,The Mafia Kills Only in Summer 2015 Re-release,413236,37134,376102,movies-2015.csv,2015,0.08986148351063315,0.9101385164893668
3762,The Moth Diaries,413035,3838,409197,movies-2012.csv,2012,0.009292190734441392,0.9907078092655586
3763,Unbranded,412792,410185,2607,movies-2015.csv,2015,0.9936844706292758,0.006315529370724239
3764,Tulsa,412269,412269,0,movies-2020.csv,2020,1.0,0.0
3765,R... Rajkumar,410495,166503,243992,movies-2013.csv,2013,0.4056151719265764,0.5943848280734235
3766,Badlapur,409166,409166,0,movies-2015.csv,2015,1.0,0.0
3767,Song One,408918,32251,376667,movies-2015.csv,2015,0.0788691131229244,0.9211308868770756
3768,The Reliant,408747,408747,0,movies-2019.csv,2019,1.0,0.0
3769,Sleeping Beauty,408680,36578,372102,movies-2011.csv,2011,0.08950278946853284,0.9104972105314671
3770,The 5th Quarter,408159,408159,0,movies-2011.csv,2011,1.0,0.0
3771,Back to the Future 2020 Re-release,407977,247000,160977,movies-2020.csv,2020,0.6054262862857465,0.3945737137142535
3772,"Love, Kennedy",407871,407871,0,movies-2017.csv,2017,1.0,0.0
3773,Please Stand By,406732,9868,396864,movies-2018.csv,2018,0.024261675993037184,0.9757383240069628
3774,Chasing Trane: The John Coltrane Documentary,406284,406284,0,movies-2017.csv,2017,1.0,0.0
3775,Gabrielle,406256,5534,400722,movies-2013.csv,2013,0.013621952660391477,0.9863780473396085
3776,The Hunting Ground,405917,405917,0,movies-2015.csv,2015,1.0,0.0
3777,Stake Land,405380,33245,372135,movies-2011.csv,2011,0.08200947259361586,0.9179905274063841
3778,Happy Magic,405268,10697,394571,movies-2011.csv,2011,0.02639487943780412,0.9736051205621958
3779,The Philadelphia Story 2018 Re-release,404524,404524,0,movies-2018.csv,2018,1.0,0.0
3780,God's Pocket,403713,169976,233737,movies-2014.csv,2014,0.4210317725711087,0.5789682274288913
3781,Meet Me in St. Louis 75th Anniversary,403521,403521,0,movies-2019.csv,2019,1.0,0.0
3782,The Apu Trilogy,402723,402723,0,movies-2015.csv,2015,1.0,0.0
3783,Drinking Buddies,401914,343341,58573,movies-2013.csv,2013,0.8542648427275487,0.14573515727245132
3784,The Oath,401463,401463,0,movies-2018.csv,2018,1.0,0.0
3785,Freetown,401328,401328,0,movies-2015.csv,2015,1.0,0.0
3786,"Hello, Dolly!",400881,400881,0,movies-2019.csv,2019,1.0,0.0
3787,Racer and the Jailbird,400026,46337,353689,movies-2017.csv,2017,0.11583497072690276,0.8841650292730973
3788,West Side Story 2018 Re-release,398670,398670,0,movies-2018.csv,2018,1.0,0.0
3789,She Dies Tomorrow,398663,398663,0,movies-2020.csv,2020,1.0,0.0
3790,Space Mutiny,397887,397887,0,movies-2018.csv,2018,1.0,0.0
3791,Berlin Syndrome,397783,28660,369123,movies-2017.csv,2017,0.07204933343053876,0.9279506665694612
3792,Krull 2018 Re-release,397157,397157,0,movies-2018.csv,2018,1.0,0.0
3793,God Bless America,393880,122550,271330,movies-2012.csv,2012,0.3111353711790393,0.6888646288209607
3794,Into the Abyss,393714,223880,169834,movies-2011.csv,2011,0.5686361165719278,0.43136388342807214
3795,Three,391957,331507,60450,movies-2016.csv,2016,0.8457738986674559,0.15422610133254414
3796,The Escape,390881,14018,376863,movies-2018.csv,2018,0.03586257710147078,0.9641374228985292
3797,Detropia,390024,390024,0,movies-2012.csv,2012,1.0,0.0
3798,Once Upon a Time in Mumbaai Dobara,389237,0,389237,movies-2013.csv,2013,0.0,1.0
3799,Singh Saab the Great,388622,225668,162954,movies-2013.csv,2013,0.580687660503008,0.4193123394969919
3800,Keep the Lights On,388331,246112,142219,movies-2012.csv,2012,0.6337686149187163,0.3662313850812838
3801,"Westwood: Punk, Icon, Activist",386856,58979,327877,movies-2018.csv,2018,0.15245724507310213,0.8475427549268979
3802,Hitchcock/Truffaut,386471,260430,126041,movies-2015.csv,2015,0.6738668619378945,0.3261331380621056
3803,The Wedding Guest,386166,386166,0,movies-2019.csv,2019,1.0,0.0
3804,How to Talk to Girls at Parties,385733,84809,300924,movies-2018.csv,2018,0.21986451768451235,0.7801354823154877
3805,Samurai Cop,384756,384756,0,movies-2017.csv,2017,1.0,0.0
3806,Bethlehem,384670,201700,182970,movies-2014.csv,2014,0.5243455429329035,0.47565445706709647
3807,The Secret World of Arrietty 2019 Re-release,384289,384289,0,movies-2019.csv,2019,1.0,0.0
3808,Digimon Adventure tri. Part 5: Coexistence,382119,52339,329780,movies-2017.csv,2017,0.1369704202094112,0.8630295797905888
3809,Z for Zachariah,381839,121461,260378,movies-2015.csv,2015,0.3180947991169053,0.6819052008830947
3810,Flower,380553,328188,52365,movies-2018.csv,2018,0.8623976161007797,0.13760238389922033
3811,Jane and Emma,380030,380030,0,movies-2018.csv,2018,1.0,0.0
3812,Daughter of Mine,379010,10628,368382,movies-2018.csv,2018,0.02804147647819319,0.9719585235218068
3813,I'll Push You: A Real-Life Inspiration,378899,378899,0,movies-2017.csv,2017,1.0,0.0
3814,Shahid,377803,12153,365650,movies-2013.csv,2013,0.03216755822478911,0.9678324417752109
3815,Miss Hokusai,377702,222670,155032,movies-2015.csv,2015,0.589538842791407,0.410461157208593
3816,Attack on Titan: Smoke Signal,377334,377334,0,movies-2018.csv,2018,1.0,0.0
3817,Le talent de mes amis,376522,889,375633,movies-2015.csv,2015,0.0023610838144915835,0.9976389161855084
3818,Great Performances at the Met: Puccini: Turandot,375295,0,375295,movies-2019.csv,2019,0.0,1.0
3819,Chronic,374704,9033,365671,movies-2016.csv,2016,0.024107028481147787,0.9758929715188522
3820,Jurassic Park 2018 Re-release,374238,374238,0,movies-2018.csv,2018,1.0,0.0
3821,Pom Poko 2018 Re-release,372405,372405,0,movies-2018.csv,2018,1.0,0.0
3822,Eloise,372137,0,372137,movies-2017.csv,2017,0.0,1.0
3823,Fanny,371657,8735,362922,movies-2013.csv,2013,0.023502853437443665,0.9764971465625564
3824,7 Boxes,370892,38106,332786,movies-2013.csv,2013,0.10274149887298728,0.8972585011270127
3825,Hava Nagila,370218,370218,0,movies-2013.csv,2013,1.0,0.0
3826,"Ruben Brandt, Collector 2018 Re-release",369809,117963,251846,movies-2018.csv,2018,0.31898358341738575,0.6810164165826142
3827,Mooz-Lum,369129,369129,0,movies-2011.csv,2011,1.0,0.0
3828,When Comedy Went to School,369065,369065,0,movies-2013.csv,2013,1.0,0.0
3829,Fatima,368600,0,368600,movies-2020.csv,2020,0.0,1.0
3830,The Void,368372,151042,217330,movies-2017.csv,2017,0.41002573485498356,0.5899742651450165
3831,Dark Awakening,367925,0,367925,movies-2015.csv,2015,0.0,1.0
3832,Yellow Rose,367849,367849,0,movies-2020.csv,2020,1.0,0.0
3833,Cunningham,367560,265102,102458,movies-2019.csv,2019,0.7212482315812384,0.27875176841876154
3834,Room 237,367406,296359,71047,movies-2012.csv,2012,0.8066253681213699,0.1933746318786302
3835,INXS: Baby Live at Wembly Stadium,366425,161750,204675,movies-2019.csv,2019,0.44142730435969163,0.5585726956403084
3836,Eat That Question,365540,355074,10466,movies-2016.csv,2016,0.9713683864966899,0.02863161350331017
3837,Glen Campbell: I'll Be Me,365422,365422,0,movies-2014.csv,2014,1.0,0.0
3838,Lords of Chaos,365353,253184,112169,movies-2019.csv,2019,0.692984592982677,0.307015407017323
3839,Clemency,364952,364716,236,movies-2019.csv,2019,0.9993533396172647,0.0006466603827352638
3840,BOSTON: An American Running Story,364369,364369,0,movies-2017.csv,2017,1.0,0.0
3841,The Kid Detective,364138,364138,0,movies-2020.csv,2020,1.0,0.0
3842,Jig,363320,183790,179530,movies-2011.csv,2011,0.5058626004624023,0.4941373995375977
3843,The Breadwinner,363307,312381,50926,movies-2017.csv,2017,0.8598265378866908,0.14017346211330914
3844,The Tobacconist,360996,0,360996,movies-2019.csv,2019,0.0,1.0
3845,These Final Hours,360234,0,360234,movies-2014.csv,2014,0.0,1.0
3846,Souvenir,359798,11411,348387,movies-2016.csv,2016,0.031715017871138805,0.9682849821288612
3847,Disney Junior HalloVeen Party!,359745,359745,0,movies-2017.csv,2017,1.0,0.0
3848,Happy Ending,359542,313770,45772,movies-2014.csv,2014,0.8726935935161956,0.1273064064838044
3849,K-12,359377,303230,56147,movies-2019.csv,2019,0.8437657390428436,0.15623426095715642
3850,Government 3,358928,249588,109340,movies-2017.csv,2017,0.695370659296572,0.304629340703428
3851,Love in Space,358486,34787,323699,movies-2011.csv,2011,0.09703865701868414,0.9029613429813159
3852,Everly,358156,0,358156,movies-2015.csv,2015,0.0,1.0
3853,Bel Canto,357462,125569,231893,movies-2018.csv,2018,0.3512792968203613,0.6487207031796387
3854,National Gallery,354971,253941,101030,movies-2014.csv,2014,0.715385200481166,0.28461479951883395
3855,Hello I Must Be Going,354939,106709,248230,movies-2012.csv,2012,0.3006403917292831,0.699359608270717
3856,The Invitation,354835,231737,123098,movies-2016.csv,2016,0.6530838276945623,0.34691617230543775
3857,Kaashmora,354631,327959,26672,movies-2016.csv,2016,0.9247894290121281,0.0752105709878719
3858,Las Acacias,354391,6000,348391,movies-2011.csv,2011,0.016930452522778514,0.9830695474772215
3859,The Tomorrow Man,354103,354103,0,movies-2019.csv,2019,1.0,0.0
3860,Long Strange Trip - The Untold Story of The Grateful Dead,351957,351957,0,movies-2017.csv,2017,1.0,0.0
3861,The Wizard of Oz 2018 Re-release,351839,351839,0,movies-2018.csv,2018,1.0,0.0
3862,Aferim!,350110,108110,242000,movies-2015.csv,2015,0.3087886664191254,0.6912113335808746
3863,Howards End 2016 Re-release,349993,160282,189711,movies-2016.csv,2016,0.45795773058318306,0.5420422694168169
3864,Tehran Taboo,349886,74758,275128,movies-2017.csv,2017,0.21366387909204712,0.7863361209079529
3865,Satanic,349183,252,348931,movies-2016.csv,2016,0.0007216846180942371,0.9992783153819058
3866,Suicide the Ripple Effect,347468,347468,0,movies-2018.csv,2018,1.0,0.0
3867,The Vault,346729,5728,341001,movies-2017.csv,2017,0.016520106480853922,0.9834798935191461
3868,Star Trek: The Motion Picture 2019 Re-release,346243,346243,0,movies-2019.csv,2019,1.0,0.0
3869,Triple Threat,345900,76289,269611,movies-2019.csv,2019,0.2205521827117664,0.7794478172882336
3870,Tesla,345229,93147,252082,movies-2020.csv,2020,0.2698122116044712,0.7301877883955288
3871,Countdown to Canelo vs. Chavez Jr.,343387,343387,0,movies-2017.csv,2017,1.0,0.0
3872,El Bulli: Cooking in Progress,343116,237181,105935,movies-2011.csv,2011,0.6912560183727952,0.3087439816272048
3873,The Idol,343059,0,343059,movies-2016.csv,2016,0.0,1.0
3874,Koch,342941,342941,0,movies-2013.csv,2013,1.0,0.0
3875,"Life, Animated",342664,255388,87276,movies-2016.csv,2016,0.7453015198561856,0.25469848014381435
3876,Bolshoi Ballet: Swan Lake,342391,88905,253486,movies-2018.csv,2018,0.25965927842729514,0.7403407215727049
3877,Nureyev: Lifting the Curtain,342255,165203,177052,movies-2018.csv,2018,0.482689807307417,0.517310192692583
3878,Knife + Heart,341847,32516,309331,movies-2018.csv,2018,0.09511857643916723,0.9048814235608328
3879,First Love,340032,218329,121703,movies-2018.csv,2018,0.642083686241295,0.3579163137587051
3880,The Lady in the Car with Glasses and a Gun,339461,2167,337294,movies-2015.csv,2015,0.006383649373565741,0.9936163506264343
3881,The Green Prince,339208,258237,80971,movies-2014.csv,2014,0.7612939553312422,0.2387060446687578
3882,Happy People: A Year in the Taiga,338987,338987,0,movies-2013.csv,2013,1.0,0.0
3883,Red Hook Summer,338803,338803,0,movies-2012.csv,2012,1.0,0.0
3884,Is It Wrong to Try to Pick Up Girls in a Dungeon - Arrow of the Orion,338632,271489,67143,movies-2019.csv,2019,0.80172281414633,0.19827718585367007
3885,Silencio,338596,158723,179873,movies-2018.csv,2018,0.46876808940448206,0.531231910595518
3886,Dark Horse,337150,166228,170922,movies-2012.csv,2012,0.4930387068070592,0.5069612931929408
3887,Voyage of Time: The IMAX Experience,337038,55409,281629,movies-2016.csv,2016,0.16439985995644407,0.8356001400435559
3888,Diane,336166,336166,0,movies-2019.csv,2019,1.0,0.0
3889,Sailor Moon R: The Movie: The Promise of the Rose/Sailor Moon S: The Movie - Hearts in Ice,335697,335697,0,movies-2018.csv,2018,1.0,0.0
3890,Freaks,335050,276591,58459,movies-2019.csv,2019,0.8255215639456798,0.17447843605432026
3891,Russ Taff: I Still Believe,334983,334983,0,movies-2018.csv,2018,1.0,0.0
3892,Bhavesh Joshi Superhero,334723,57376,277347,movies-2018.csv,2018,0.1714133776286661,0.828586622371334
3893,Anthropocene: The Human Epoch,334162,104806,229356,movies-2019.csv,2019,0.3136382951981374,0.6863617048018625
3894,A Silent Voice: The Movie 2019 Re-release,333984,333984,0,movies-2019.csv,2019,1.0,0.0
3895,Ballet 422,333554,333554,0,movies-2015.csv,2015,1.0,0.0
3896,Shine,333388,333388,0,movies-2018.csv,2018,1.0,0.0
3897,Something from Nothing: The Art of Rap,333388,288000,45388,movies-2012.csv,2012,0.8638583272343335,0.13614167276566644
3898,Linsanity,332990,302645,30345,movies-2013.csv,2013,0.9088711372713896,0.09112886272861047
3899,Don't Hang Up,332571,0,332571,movies-2017.csv,2017,0.0,1.0
3900,Shamitabh,331821,324597,7224,movies-2015.csv,2015,0.9782292259983545,0.021770774001645465
3901,The Big Fight Live: IBF Welterweight Title: Errol Spence Jr. vs. Mikey Garcia,328979,328979,0,movies-2019.csv,2019,1.0,0.0
3902,Ladies vs. Ricky Bahl,328870,0,328870,movies-2011.csv,2011,0.0,1.0
3903,The Last Sentence,328005,62506,265499,movies-2012.csv,2012,0.19056416822914285,0.8094358317708572
3904,Elaine Stritch: Shoot Me,327452,327452,0,movies-2014.csv,2014,1.0,0.0
3905,You Will Be My Son 2012 Re-release,326061,285151,40910,movies-2012.csv,2012,0.8745326794679523,0.12546732053204768
3906,Lucy in the Sky,325950,319976,5974,movies-2019.csv,2019,0.9816720355882804,0.018327964411719588
3907,The Central Park Five,325653,325653,0,movies-2012.csv,2012,1.0,0.0
3908,The Opera House,325235,320079,5156,movies-2018.csv,2018,0.9841468476639968,0.015853152336003196
3909,Irresistible,325059,0,325059,movies-2020.csv,2020,0.0,1.0
3910,Camp,324977,324977,0,movies-2013.csv,2013,1.0,0.0
3911,Juan of the Dead,324834,18000,306834,movies-2012.csv,2012,0.05541291859842258,0.9445870814015774
3912,Teefa In Trouble,324633,0,324633,movies-2018.csv,2018,0.0,1.0
3913,The Bolshoi Ballet: Live From Moscow - The Nutcracker,323928,323928,0,movies-2018.csv,2018,1.0,0.0
3914,The Cured,323776,26630,297146,movies-2018.csv,2018,0.08224822099229097,0.917751779007709
3915,Three Worlds,323748,3952,319796,movies-2012.csv,2012,0.012207025217144198,0.9877929747828558
3916,Sword of Trust,323369,322421,948,movies-2019.csv,2019,0.9970683646236962,0.002931635376303851
3917,Damsel,323235,305136,18099,movies-2018.csv,2018,0.944006682444661,0.055993317555339
3918,Citizen Jane: Battle for the City,323124,313411,9713,movies-2017.csv,2017,0.9699403325039304,0.03005966749606962
3919,The Day He Arrives,322348,13746,308602,movies-2011.csv,2011,0.042643354387184036,0.957356645612816
3920,Nocturama,321768,30157,291611,movies-2016.csv,2016,0.09372280649411999,0.90627719350588
3921,Double Trouble,321081,44788,276293,movies-2012.csv,2012,0.13949128101631675,0.8605087189836832
3922,Woodstock,320610,126562,194048,movies-2019.csv,2019,0.39475375066279905,0.605246249337201
3923,Bohemian Rhapsody 2020 Re-release,320550,240000,80550,movies-2020.csv,2020,0.7487131492746841,0.25128685072531587
3924,The English Teacher,320013,104810,215203,movies-2013.csv,2013,0.3275179445835013,0.6724820554164987
3925,Beats,319595,0,319595,movies-2019.csv,2019,0.0,1.0
3926,Meeting Gorbachev,319230,251837,67393,movies-2019.csv,2019,0.7888888888888889,0.2111111111111111
3927,You Are Here: A Come From Away Story,318885,318885,0,movies-2019.csv,2019,1.0,0.0
3928,West of Memphis,318317,310154,8163,movies-2012.csv,2012,0.9743557522846722,0.025644247715327802
3929,Ask Dr. Ruth,318230,297195,21035,movies-2019.csv,2019,0.9339000094271439,0.06609999057285611
3930,The Student,318123,1126,316997,movies-2016.csv,2016,0.003539511446830314,0.9964604885531697
3931,Not Today,318121,318121,0,movies-2013.csv,2013,1.0,0.0
3932,Inch'Allah,317656,9840,307816,movies-2013.csv,2013,0.030976905835243155,0.9690230941647568
3933,Okko's Inn,317547,134787,182760,movies-2018.csv,2018,0.42446315033680054,0.5755368496631995
3934,Sauvage / Wild,317536,61604,255932,movies-2018.csv,2018,0.19400634888642548,0.8059936511135746
3935,6 Days,316946,0,316946,movies-2017.csv,2017,0.0,1.0
3936,5 Days of War,316944,17479,299465,movies-2011.csv,2011,0.05514854359129689,0.9448514564087032
3937,AmeriGeddon,316554,316554,0,movies-2016.csv,2016,1.0,0.0
3938,Corpo Celeste 2011 Re-release,316504,8919,307585,movies-2011.csv,2011,0.028179738644693274,0.9718202613553067
3939,The Riot and the Dance,316103,316103,0,movies-2018.csv,2018,1.0,0.0
3940,David and Goliath,316100,316100,0,movies-2015.csv,2015,1.0,0.0
3941,Josh Groban Bridges Live from Madison Square Garden,315173,315173,0,movies-2019.csv,2019,1.0,0.0
3942,Obit.,315049,315049,0,movies-2017.csv,2017,1.0,0.0
3943,Time Out of Mind,314082,166775,147307,movies-2015.csv,2015,0.5309919065721691,0.46900809342783095
3944,Christine,313465,298525,14940,movies-2016.csv,2016,0.9523391766225895,0.04766082337741056
3945,War Witch,313387,70544,242843,movies-2012.csv,2012,0.22510187084977998,0.77489812915022
3946,The Bolshoi Ballet: Live From Moscow - Romeo and Juliet,313088,313088,0,movies-2018.csv,2018,1.0,0.0
3947,Berberian Sound Studio,312757,38493,274264,movies-2012.csv,2012,0.1230763819834568,0.8769236180165432
3948,The Hornet's Nest,312706,312706,0,movies-2014.csv,2014,1.0,0.0
3949,David Lynch: The Art Life,311470,171419,140051,movies-2017.csv,2017,0.5503547693196776,0.44964523068032236
3950,Plácido Domingo Gala,311246,52502,258744,movies-2019.csv,2019,0.16868329231540324,0.8313167076845968
3951,Dancing in Jaffa,311001,151098,159903,movies-2014.csv,2014,0.48584409696431846,0.5141559030356816
3952,Being Elmo: A Puppeteer's Journey,310812,304052,6760,movies-2011.csv,2011,0.9782505179980181,0.021749482001981905
3953,I Am Eleven 2014 Re-release,310116,310116,0,movies-2014.csv,2014,1.0,0.0
3954,The Amazing Catfish,308349,11342,297007,movies-2014.csv,2014,0.03678299589101959,0.9632170041089804
3955,Merchants of Doubt,308156,308156,0,movies-2015.csv,2015,1.0,0.0
3956,Great Performances at the Met: MET Opera: Magic Flute,307686,307686,0,movies-2018.csv,2018,1.0,0.0
3957,Sputnik,307062,18853,288209,movies-2020.csv,2020,0.061398023851860536,0.9386019761481394
3958,Half of a Yellow Sun,306393,54529,251864,movies-2014.csv,2014,0.17797077609475412,0.8220292239052459
3959,The Mercy 2018 Re-release,306205,29538,276667,movies-2018.csv,2018,0.09646478666253,0.90353521333747
3960,Monsters: Dark Continent,306004,0,306004,movies-2015.csv,2015,0.0,1.0
3961,Under the Sun,305993,105036,200957,movies-2016.csv,2016,0.3432627543767341,0.6567372456232659
3962,The Third Wife,305755,84933,220822,movies-2019.csv,2019,0.27778123006982713,0.7222187699301729
3963,The Kingmaker,304840,122587,182253,movies-2019.csv,2019,0.4021355465162052,0.5978644534837948
3964,Showtime Championship Boxing: Deontay Wilder vs. Tyson Fury,304482,304482,0,movies-2018.csv,2018,1.0,0.0
3965,Microbe & Gasoline,303787,63802,239985,movies-2015.csv,2015,0.21002215368004556,0.7899778463199545
3966,N.H 10,303587,303587,0,movies-2015.csv,2015,1.0,0.0
3967,The Bolshoi Ballet: Live From Moscow - Giselle,302681,302681,0,movies-2018.csv,2018,1.0,0.0
3968,The Unknown Known,301604,276497,25107,movies-2014.csv,2014,0.9167550828238352,0.08324491717616478
3969,Save Yourselves!,301162,301162,0,movies-2020.csv,2020,1.0,0.0
3970,Cliffs of Freedom,300842,72476,228366,movies-2019.csv,2019,0.2409105111653293,0.7590894888346706
3971,Sunset Blvd. 2018 Re-release,299645,299645,0,movies-2018.csv,2018,1.0,0.0
3972,Jinn,297381,202348,95033,movies-2014.csv,2014,0.6804335179449931,0.3195664820550069
3973,Kaptaan,296715,203790,92925,movies-2016.csv,2016,0.6868206865173652,0.31317931348263484
3974,The We and the I,295930,42172,253758,movies-2012.csv,2012,0.1425066738755787,0.8574933261244213
3975,Harry Potter and the Sorcerer's Stone 2018 Re-release,295917,295917,0,movies-2018.csv,2018,1.0,0.0
3976,Chic!,295295,5587,289708,movies-2015.csv,2015,0.018920062987859598,0.9810799370121404
3977,Gremlins 2020 Re-release,295238,295000,238,movies-2020.csv,2020,0.9991938707077003,0.0008061292922997717
3978,The Tenth Man,295129,63564,231565,movies-2016.csv,2016,0.21537700463187284,0.7846229953681272
3979,Aftershock,294696,58510,236186,movies-2013.csv,2013,0.19854358389662569,0.8014564161033744
3980,Shakira in Concert: El Dorado World Tour,294677,271586,23091,movies-2019.csv,2019,0.9216396257597301,0.07836037424026986
3981,Khodorkovsky,294599,39522,255077,movies-2011.csv,2011,0.1341552415317092,0.8658447584682908
3982,Innocence,294039,294039,0,movies-2014.csv,2014,1.0,0.0
3983,The Giant Spider Invasion,293053,293053,0,movies-2019.csv,2019,1.0,0.0
3984,Stonewall,292669,187674,104995,movies-2015.csv,2015,0.6412500128131097,0.35874998718689033
3985,The Last Five Years,292092,145427,146665,movies-2015.csv,2015,0.4978808046779782,0.5021191953220219
3986,Dreams of a Life,291898,8405,283493,movies-2011.csv,2011,0.02879430485991682,0.9712056951400831
3987,The Godfather: Part II 45th Anniversary,291754,291754,0,movies-2019.csv,2019,1.0,0.0
3988,The Man in 3B,291513,291513,0,movies-2015.csv,2015,1.0,0.0
3989,Big Bad Wolves,291239,33232,258007,movies-2014.csv,2014,0.11410559712126467,0.8858944028787353
3990,Come Away,290569,126081,164488,movies-2020.csv,2020,0.4339107062350079,0.5660892937649922
3991,More Than Funny,290498,290498,0,movies-2018.csv,2018,1.0,0.0
3992,Jimmy Vestvood: Amerikan Hero,290080,230069,60011,movies-2016.csv,2016,0.7931225868725869,0.20687741312741312
3993,Best F(r)iends: Volume 1,290064,252410,37654,movies-2018.csv,2018,0.8701872690164929,0.1298127309835071
3994,The Zoya Factor,289631,128831,160800,movies-2019.csv,2019,0.4448108109974416,0.5551891890025584
3995,Best Night Ever,289511,0,289511,movies-2014.csv,2014,0.0,1.0
3996,The Silence of Others,289455,67986,221469,movies-2018.csv,2018,0.2348758874436441,0.7651241125563559
3997,Welcome to New York,288837,0,288837,movies-2014.csv,2014,0.0,1.0
3998,Antarctica: A Year on Ice,288757,288757,0,movies-2014.csv,2014,1.0,0.0
3999,Above and Beyond,288751,288751,0,movies-2015.csv,2015,1.0,0.0
4000,The Last of Robin Hood,288545,288545,0,movies-2014.csv,2014,1.0,0.0
4001,Saga of Tanya the Evil - The Movie,288460,288460,0,movies-2019.csv,2019,1.0,0.0
4002,Resistance,288064,7464,280600,movies-2020.csv,2020,0.025910908686958455,0.9740890913130416
4003,Generation Wealth,287709,237709,50000,movies-2018.csv,2018,0.8262132919025821,0.17378670809741786
4004,Skate Kitchen,287307,236799,50508,movies-2018.csv,2018,0.824201986028882,0.175798013971118
4005,The Interrupters,286457,282448,4009,movies-2011.csv,2011,0.9860048803136248,0.013995119686375268
4006,The Dark and the Wicked,285289,110618,174671,movies-2020.csv,2020,0.38774015121508365,0.6122598487849163
4007,But Deliver Us from Evil,285169,285169,0,movies-2018.csv,2018,1.0,0.0
4008,The Silence 2012 Re-release,284471,100214,184257,movies-2012.csv,2012,0.35228195492686426,0.6477180450731358
4009,Khalid: Free Spirit,284229,284229,0,movies-2019.csv,2019,1.0,0.0
4010,The Anonymous People,284147,284147,0,movies-2013.csv,2013,1.0,0.0
4011,The Kindergarten Teacher,284065,36190,247875,movies-2014.csv,2014,0.12740041891820533,0.8725995810817947
4012,Disney's Newsies: The Broadway Musical! 2018 Re-release,282429,282429,0,movies-2018.csv,2018,1.0,0.0
4013,Created Equal: Clarence Thomas in His Own Words,282149,282149,0,movies-2020.csv,2020,1.0,0.0
4014,Tumbledown,282083,135026,147057,movies-2016.csv,2016,0.47867471630690256,0.5213252836930974
4015,Ho Mann Jahaan,281926,208611,73315,movies-2016.csv,2016,0.7399494902917787,0.2600505097082213
4016,Mike Wallace Is Here,281245,281245,0,movies-2019.csv,2019,1.0,0.0
4017,Octaman,280710,280710,0,movies-2019.csv,2019,1.0,0.0
4018,I Do... Until I Don't,280668,280668,0,movies-2017.csv,2017,1.0,0.0
4019,The Black Power Mixtape 1967-1975,280025,273749,6276,movies-2011.csv,2011,0.9775877153825552,0.02241228461744487
4020,Wonders of the Sea,279415,100780,178635,movies-2018.csv,2018,0.360682139469964,0.6393178605300359
4021,Havenhurst,279372,0,279372,movies-2016.csv,2016,0.0,1.0
4022,"Lou Andreas-Salomé, The Audacity to be Free",278982,12875,266107,movies-2017.csv,2017,0.04614993081990953,0.9538500691800905
4023,The Secrets We Keep,278618,207928,70690,movies-2020.csv,2020,0.7462834418451069,0.2537165581548931
4024,10 Years,278336,203373,74963,movies-2012.csv,2012,0.730674436652104,0.2693255633478961
4025,Bolshoi Ballet: The Golden Age,277666,171916,105750,movies-2019.csv,2019,0.6191467446500472,0.38085325534995285
4026,The Summit,277651,243550,34101,movies-2013.csv,2013,0.8771803451095079,0.12281965489049201
4027,Science Fair,277338,276195,1143,movies-2018.csv,2018,0.9958786751184475,0.004121324881552474
4028,See You Soon,277126,0,277126,movies-2019.csv,2019,0.0,1.0
4029,True Grit 2019 Re-release,276418,276418,0,movies-2019.csv,2019,1.0,0.0
4030,Life After Beth,274717,88273,186444,movies-2014.csv,2014,0.3213233982607556,0.6786766017392444
4031,Lovely Molly,274480,18464,256016,movies-2012.csv,2012,0.06726901777907315,0.9327309822209269
4032,Swallow,274259,33419,240840,movies-2020.csv,2020,0.1218519720410269,0.8781480279589731
4033,The King,273601,259291,14310,movies-2018.csv,2018,0.9476975595849431,0.05230244041505696
4034,Slayer: The Repentless Killogy,272874,268727,4147,movies-2019.csv,2019,0.9848025095831776,0.015197490416822416
4035,Chavela,272842,148666,124176,movies-2017.csv,2017,0.5448794540429992,0.45512054595700074
4036,One Child Nation,271841,270128,1713,movies-2019.csv,2019,0.993698522297961,0.0063014777020390595
4037,Come Out and Play,271735,2638,269097,movies-2013.csv,2013,0.009707987561410933,0.9902920124385891
4038,The Tale of The Princess Kaguya 2019 Re-release,271681,271681,0,movies-2019.csv,2019,1.0,0.0
4039,Aloft,270971,53086,217885,movies-2015.csv,2015,0.19591026345992746,0.8040897365400725
4040,The Canyons,270185,56825,213360,movies-2013.csv,2013,0.21031885559894148,0.7896811444010585
4041,Exposed,269915,0,269915,movies-2016.csv,2016,0.0,1.0
4042,Stalker,269881,269881,0,movies-2017.csv,2017,1.0,0.0
4043,Shirin Farhad Ki Toh Nikal Padi,269845,155758,114087,movies-2012.csv,2012,0.5772128444106802,0.4227871555893198
4044,The Loneliest Planet,268933,129579,139354,movies-2012.csv,2012,0.4818263284907393,0.5181736715092606
4045,The World Before Your Feet,268644,268644,0,movies-2018.csv,2018,1.0,0.0
4046,Meri Pyaari Bindu,268067,0,268067,movies-2017.csv,2017,0.0,1.0
4047,The Carer,267995,6208,261787,movies-2016.csv,2016,0.023164611280061195,0.9768353887199388
4048,Conan O'Brien Can't Stop,267965,267965,0,movies-2011.csv,2011,1.0,0.0
4049,An American in Paris 2020 Re-release,267824,267824,0,movies-2020.csv,2020,1.0,0.0
4050,Falcon Rising,267476,11774,255702,movies-2014.csv,2014,0.04401890263051638,0.9559810973694837
4051,Munger Road,266689,266689,0,movies-2011.csv,2011,1.0,0.0
4052,Never Rarely Sometimes Always,265938,16565,249373,movies-2020.csv,2020,0.06228895456835804,0.937711045431642
4053,Luzia: Cirque du Soleil in Cinema,265673,265673,0,movies-2019.csv,2019,1.0,0.0
4054,Félicité,265495,12433,253062,movies-2017.csv,2017,0.04682950714702725,0.9531704928529727
4055,Out of Liberty,265279,265279,0,movies-2019.csv,2019,1.0,0.0
4056,"Asbury Park: Riot, Redemption, Rock & Roll",264983,167684,97299,movies-2019.csv,2019,0.6328104067053358,0.36718959329466416
4057,Doctor Who,264629,264629,0,movies-2018.csv,2018,1.0,0.0
4058,Phil Ochs: There But for Fortune,263723,263723,0,movies-2011.csv,2011,1.0,0.0
4059,The Producers 2018 Re-release,263277,216807,46470,movies-2018.csv,2018,0.8234938866668946,0.17650611333310542
4060,Grand départ,262412,677,261735,movies-2013.csv,2013,0.0025799125040013413,0.9974200874959986
4061,Augustine,262390,107352,155038,movies-2013.csv,2013,0.40913144555813863,0.5908685544418614
4062,The Final Year,262286,191900,70386,movies-2018.csv,2018,0.73164408317638,0.26835591682362003
4063,Minimalism: A Documentary About the Important Things,261865,261865,0,movies-2016.csv,2016,1.0,0.0
4064,Any Day Now,261747,201395,60352,movies-2012.csv,2012,0.7694262016374591,0.23057379836254094
4065,Half Girlfriend,261597,0,261597,movies-2017.csv,2017,0.0,1.0
4066,Eating You Alive,260534,260534,0,movies-2018.csv,2018,1.0,0.0
4067,Her Smell,260481,255599,4882,movies-2019.csv,2019,0.9812577500854189,0.0187422499145811
4068,Star Raiders: The Adventures of Saber Raine,260234,260234,0,movies-2019.csv,2019,1.0,0.0
4069,The Cave,258921,62625,196296,movies-2019.csv,2019,0.24186914155282885,0.7581308584471711
4070,The Unspoken,258760,0,258760,movies-2016.csv,2016,0.0,1.0
4071,Across the Universe 2018 Re-release,258618,258618,0,movies-2018.csv,2018,1.0,0.0
4072,Big 2018 Re-release,258507,258507,0,movies-2018.csv,2018,1.0,0.0
4073,The Music Never Stopped,258223,258223,0,movies-2011.csv,2011,1.0,0.0
4074,Spiders,257019,0,257019,movies-2013.csv,2013,0.0,1.0
4075,Raja Natwarlal,256978,131105,125873,movies-2014.csv,2014,0.5101798597545315,0.4898201402454685
4076,Helicopter Eela,256952,71971,184981,movies-2018.csv,2018,0.2800951150409415,0.7199048849590585
4077,Alive Inside: A Story of Music and Memory,256682,256682,0,movies-2014.csv,2014,1.0,0.0
4078,Officer Down,255080,1463,253617,movies-2013.csv,2013,0.005735455543358946,0.994264544456641
4079,Dean,254536,254536,0,movies-2017.csv,2017,1.0,0.0
4080,Fall in Love Like a Star 2015 Re-release,253785,212508,41277,movies-2015.csv,2015,0.8373544535729062,0.1626455464270938
4081,Mistaken for Strangers,253285,138991,114294,movies-2014.csv,2014,0.5487533805791894,0.45124661942081057
4082,Battlefield America,252805,172000,80805,movies-2012.csv,2012,0.6803662902236902,0.3196337097763098
4083,Play the Flute,252572,252572,0,movies-2019.csv,2019,1.0,0.0
4084,When Harry Met Sally... 30th Anniversary,252320,252320,0,movies-2019.csv,2019,1.0,0.0
4085,I Got the Hook Up 2,252293,252293,0,movies-2019.csv,2019,1.0,0.0
4086,Canal Street,251917,251917,0,movies-2019.csv,2019,1.0,0.0
4087,Gook,251541,250130,1411,movies-2017.csv,2017,0.994390576486537,0.005609423513463014
4088,The Twilight Zone: A 60th Anniversary Celebration,248514,248514,0,movies-2019.csv,2019,1.0,0.0
4089,Band Aid,248370,248370,0,movies-2017.csv,2017,1.0,0.0
4090,The Attacks of 26/11,248346,248346,0,movies-2013.csv,2013,1.0,0.0
4091,Wild Oats,247949,40598,207351,movies-2016.csv,2016,0.16373528427216888,0.8362647157278311
4092,Doctor Who: The End of Time: Part One,247798,247798,0,movies-2019.csv,2019,1.0,0.0
4093,Lilting,247377,27054,220323,movies-2014.csv,2014,0.10936344122533623,0.8906365587746637
4094,The Galapagos Affair: Satan Came to Eden,247159,247159,0,movies-2014.csv,2014,1.0,0.0
4095,The Notebook 2013 Re-release,246557,66559,179998,movies-2013.csv,2013,0.2699538037857372,0.7300461962142628
4096,The Love Witch,246218,228894,17324,movies-2016.csv,2016,0.9296395876824602,0.07036041231753974
4097,Friendsgiving Day #1,246168,246168,0,movies-2019.csv,2019,1.0,0.0
4098,Hot Summer Nights,246133,0,246133,movies-2018.csv,2018,0.0,1.0
4099,Harry Potter and the Chamber of Secrets 2018 Re-release,245501,245501,0,movies-2018.csv,2018,1.0,0.0
4100,American Woman,245416,236637,8779,movies-2019.csv,2019,0.9642280861883495,0.03577191381165042
4101,The Fireflies Are Gone,245006,245006,0,movies-2018.csv,2018,1.0,0.0
4102,The Waiting Room,244951,244951,0,movies-2012.csv,2012,1.0,0.0
4103,Term Life,243793,21256,222537,movies-2016.csv,2016,0.08718872157937266,0.9128112784206274
4104,My Uncle Rafael,243616,243616,0,movies-2012.csv,2012,1.0,0.0
4105,Rangeelay,243246,148418,94828,movies-2013.csv,2013,0.6101559737878526,0.38984402621214737
4106,Out of Blue,242847,18779,224068,movies-2019.csv,2019,0.07732852372069657,0.9226714762793035
4107,My Perestroika,242707,242707,0,movies-2011.csv,2011,1.0,0.0
4108,Tevar,242453,236002,6451,movies-2015.csv,2015,0.9733927812813205,0.026607218718679496
4109,Archive,242195,139593,102602,movies-2020.csv,2020,0.576366151241768,0.423633848758232
4110,Ophelia,242115,50722,191393,movies-2019.csv,2019,0.2094954876814737,0.7905045123185264
4111,Road to Ninja - Naruto the Movie 2014 Re-release,240687,43171,197516,movies-2014.csv,2014,0.17936573225807792,0.820634267741922
4112,Boulevard,240450,126150,114300,movies-2015.csv,2015,0.5246412975670618,0.47535870243293826
4113,Carter High,240214,240214,0,movies-2015.csv,2015,1.0,0.0
4114,Of Horses and Men,239969,11894,228075,movies-2013.csv,2013,0.04956473544499498,0.950435264555005
4115,Dark River,239182,7714,231468,movies-2018.csv,2018,0.03225159083877549,0.9677484091612245
4116,311 Enlarged to Show Detail 3,238791,238791,0,movies-2019.csv,2019,1.0,0.0
4117,Crown Heights,238558,238558,0,movies-2017.csv,2017,1.0,0.0
4118,RWBY: Argus Limited,238379,238379,0,movies-2018.csv,2018,1.0,0.0
4119,Red Obsession,238223,13199,225024,movies-2013.csv,2013,0.05540606910331916,0.9445939308966809
4120,American Satan,237708,237708,0,movies-2017.csv,2017,1.0,0.0
4121,Tokyo Godfathers 2020 Re-release,237571,237571,0,movies-2020.csv,2020,1.0,0.0
4122,The Trip to Greece,237473,8340,229133,movies-2020.csv,2020,0.0351197820383791,0.9648802179616209
4123,Alien Intrusion: Unmasking a Deception,237411,237411,0,movies-2018.csv,2018,1.0,0.0
4124,Shuddh Desi Romance,237249,0,237249,movies-2013.csv,2013,0.0,1.0
4125,Middle of Nowhere,236806,236806,0,movies-2012.csv,2012,1.0,0.0
4126,India's Most Wanted,235351,176858,58493,movies-2019.csv,2019,0.7514648333765312,0.24853516662346878
4127,Varda by Agnès,235262,160765,74497,movies-2019.csv,2019,0.683344526527871,0.31665547347212897
4128,Diamantino,235041,70088,164953,movies-2018.csv,2018,0.29819478303785296,0.701805216962147
4129,Art and Craft,235037,235037,0,movies-2014.csv,2014,1.0,0.0
4130,Blind Eyes Opened,234505,234505,0,movies-2020.csv,2020,1.0,0.0
4131,After the Ball,234417,161820,72597,movies-2015.csv,2015,0.6903082967532218,0.3096917032467782
4132,Little Shop of Horrors 2017 Re-release,233865,233865,0,movies-2017.csv,2017,1.0,0.0
4133,Superman 2018 Re-release,233585,233585,0,movies-2018.csv,2018,1.0,0.0
4134,Premier Boxing Champions: PBC on FOX: Spence vs. Porter,232973,232973,0,movies-2019.csv,2019,1.0,0.0
4135,Lost and Found in Armenia,232857,122305,110552,movies-2012.csv,2012,0.5252365185500114,0.47476348144998864
4136,Bishôjo senshi Sailor Moon Super S Special,231434,231434,0,movies-2018.csv,2018,1.0,0.0
4137,A Place at the Table,231378,231378,0,movies-2013.csv,2013,1.0,0.0
4138,DAZN Boxing: Canelo Alvarez vs. Daniel Jacobs,230703,230703,0,movies-2019.csv,2019,1.0,0.0
4139,"Life, Above All",230529,134461,96068,movies-2011.csv,2011,0.5832715189845963,0.4167284810154037
4140,Shirley,230441,0,230441,movies-2020.csv,2020,0.0,1.0
4141,Chakravyuh,230136,151778,78358,movies-2012.csv,2012,0.6595143741092224,0.34048562589077763
4142,"Belle and Sebastian, Friends for Life 2018 Re-release",229983,105890,124093,movies-2018.csv,2018,0.4604253357856885,0.5395746642143114
4143,Wrecked,229532,8020,221512,movies-2011.csv,2011,0.03494066186849764,0.9650593381315024
4144,The Last Tree,228676,10128,218548,movies-2019.csv,2019,0.04428973744511886,0.9557102625548811
4145,Doctor Who Live Q&A And Screening,228615,228615,0,movies-2020.csv,2020,1.0,0.0
4146,City of Ghosts,228225,128015,100210,movies-2017.csv,2017,0.560915762953226,0.439084237046774
4147,Jeremiah Tower: The Last Magnificent,228153,228153,0,movies-2017.csv,2017,1.0,0.0
4148,InAPPropriate Comedy,228004,228004,0,movies-2013.csv,2013,1.0,0.0
4149,Like Water,227332,0,227332,movies-2012.csv,2012,0.0,1.0
4150,Studio 54,227062,199767,27295,movies-2018.csv,2018,0.879790541790348,0.120209458209652
4151,Mine 9,226421,226421,0,movies-2019.csv,2019,1.0,0.0
4152,Rumble: The Indians Who Rocked The World,226006,226006,0,movies-2017.csv,2017,1.0,0.0
4153,Dr. Cabbie,225490,225490,0,movies-2014.csv,2014,1.0,0.0
4154,Millennium Actress 2019 Re-release,225250,225250,0,movies-2019.csv,2019,1.0,0.0
4155,Experimenter,224145,155575,68570,movies-2015.csv,2015,0.6940819558767762,0.3059180441232238
4156,Tampopo,224097,224097,0,movies-2016.csv,2016,1.0,0.0
4157,Extra Ordinary,223898,164346,59552,movies-2019.csv,2019,0.7340217420432519,0.2659782579567482
4158,Premier Boxing Champions: PBC on FOX PPV: Pacquiao vs. Thurman,223858,223858,0,movies-2019.csv,2019,1.0,0.0
4159,Crystal Fairy & the Magical Cactus,223821,202370,21451,movies-2013.csv,2013,0.9041600207308519,0.09583997926914811
4160,BuyBust,223720,178471,45249,movies-2018.csv,2018,0.7977427141069193,0.20225728589308065
4161,Tim and Eric's Billion Dollar Movie,223580,201436,22144,movies-2012.csv,2012,0.9009571518024868,0.09904284819751319
4162,Take Every Wave: The Life of Laird Hamilton,223301,176076,47225,movies-2017.csv,2017,0.7885141580198924,0.21148584198010756
4163,Never Surrender: A Galaxy Quest Documentary,222971,222971,0,movies-2019.csv,2019,1.0,0.0
4164,Spirit of the Game,222565,222565,0,movies-2016.csv,2016,1.0,0.0
4165,10.000 Km,222530,12423,210107,movies-2014.csv,2014,0.055826180739675546,0.9441738192603244
4166,High School,221590,139034,82556,movies-2012.csv,2012,0.627438061284354,0.372561938715646
4167,Neil Young Journeys,221082,215026,6056,movies-2012.csv,2012,0.9726074488198949,0.02739255118010512
4168,Phantom Boy,221016,34362,186654,movies-2015.csv,2015,0.15547290693886415,0.8445270930611358
4169,Little Pink House,220948,220948,0,movies-2018.csv,2018,1.0,0.0
4170,Supermensch,220065,213064,7001,movies-2014.csv,2014,0.9681866721196011,0.03181332788039897
4171,Great Performances at the Met: Puccini: Turandot,219619,172627,46992,movies-2016.csv,2016,0.7860294418971037,0.2139705581028964
4172,Brooklyn Castle,219407,219407,0,movies-2012.csv,2012,1.0,0.0
4173,Fragments of Truth,219342,219342,0,movies-2018.csv,2018,1.0,0.0
4174,Club Life,219229,4444,214785,movies-2015.csv,2015,0.020271040783837905,0.9797289592161621
4175,The House I Live In,219159,210752,8407,movies-2012.csv,2012,0.9616397227583626,0.03836027724163735
4176,Harry Potter and the Prisoner of Azkaban 2018 Re-release,218774,218774,0,movies-2018.csv,2018,1.0,0.0
4177,California Typewriter,218563,218563,0,movies-2017.csv,2017,1.0,0.0
4178,Dark Money,217932,217932,0,movies-2018.csv,2018,1.0,0.0
4179,Getting Grace,217812,217812,0,movies-2018.csv,2018,1.0,0.0
4180,Complete Unknown,217473,191761,25712,movies-2016.csv,2016,0.881769231122944,0.118230768877056
4181,The Karate Kid 2019 Re-release,215447,215447,0,movies-2019.csv,2019,1.0,0.0
4182,The Treasure of the Sierra Madre,215295,215295,0,movies-2018.csv,2018,1.0,0.0
4183,The Tribe,215034,150564,64470,movies-2015.csv,2015,0.7001869471804458,0.2998130528195541
4184,Risk,214669,200219,14450,movies-2017.csv,2017,0.9326870670660412,0.06731293293395879
4185,Hamlet 2019 Re-release,214578,214578,0,movies-2019.csv,2019,1.0,0.0
4186,The Pervert's Guide to Ideology,214313,67966,146347,movies-2013.csv,2013,0.31713428490105594,0.6828657150989441
4187,Ingrid Bergman: In Her Own Words,214014,138148,75866,movies-2015.csv,2015,0.6455091722971394,0.35449082770286056
4188,Marjorie Prime,213858,180608,33250,movies-2017.csv,2017,0.844523001243816,0.155476998756184
4189,Thaandavam,213476,213476,0,movies-2012.csv,2012,1.0,0.0
4190,The Wound,213043,30678,182365,movies-2017.csv,2017,0.14399909877348704,0.856000901226513
4191,The Afflicted,212940,212940,0,movies-2011.csv,2011,1.0,0.0
4192,Chocolate City,212662,212662,0,movies-2015.csv,2015,1.0,0.0
4193,Young & Wild,212624,5514,207110,movies-2012.csv,2012,0.025933102566032058,0.9740668974339679
4194,Big Sonia,212471,212471,0,movies-2017.csv,2017,1.0,0.0
4195,Fatima,212228,50105,162123,movies-2016.csv,2016,0.23609043104585634,0.7639095689541436
4196,Donnie Darko 2016 Re-release,212034,207971,4063,movies-2016.csv,2016,0.9808379788147183,0.019162021185281607
4197,Somewhere Between,210975,210975,0,movies-2012.csv,2012,1.0,0.0
4198,A Glimpse Inside the Mind of Charles Swan III,210565,45350,165215,movies-2013.csv,2013,0.2153729252249899,0.7846270747750101
4199,Tigers Are Not Afraid 2019 Re-release,210138,175559,34579,movies-2019.csv,2019,0.8354462305722906,0.1645537694277094
4200,Beware of Mr. Baker,210123,116476,93647,movies-2012.csv,2012,0.5543229441803135,0.4456770558196866
4201,"Faith, Hope & Love",210091,210091,0,movies-2019.csv,2019,1.0,0.0
4202,The Death of Louis XIV,209715,43635,166080,movies-2016.csv,2016,0.2080680924111294,0.7919319075888707
4203,Rob the Mob,209613,208693,920,movies-2014.csv,2014,0.99561095924394,0.004389040756059977
4204,SEED: The Untold Story,209580,207825,1755,movies-2016.csv,2016,0.9916261093615804,0.008373890638419696
4205,Kathy Griffin: A Hell of a Story,208907,208907,0,movies-2019.csv,2019,1.0,0.0
4206,Casablanca 2013 Re-release,208608,208608,0,movies-2013.csv,2013,1.0,0.0
4207,Agent Mr. Chan,208351,208351,0,movies-2018.csv,2018,1.0,0.0
4208,The Right Kind of Wrong,208105,2098,206007,movies-2014.csv,2014,0.010081449268398164,0.9899185507316018
4209,The Dating Project,208100,208100,0,movies-2018.csv,2018,1.0,0.0
4210,Batman 2019 Re-release,207901,159419,48482,movies-2019.csv,2019,0.766802468482595,0.2331975315174049
4211,Under the Electric Sky,207584,207584,0,movies-2014.csv,2014,1.0,0.0
4212,Heading Home: The Tale of Team Israel,207533,207533,0,movies-2018.csv,2018,1.0,0.0
4213,Advanced Style,207231,87879,119352,movies-2014.csv,2014,0.4240630021570132,0.5759369978429868
4214,Ek Thi Daayan,206279,112135,94144,movies-2013.csv,2013,0.5436084138472651,0.4563915861527349
4215,Don't Call Me Son,205987,11678,194309,movies-2016.csv,2016,0.05669289809551088,0.9433071019044891
4216,The Desert Bride,205350,30110,175240,movies-2017.csv,2017,0.14662770878987094,0.853372291210129
4217,Sicilian Ghost Story,204892,15285,189607,movies-2017.csv,2017,0.07460027721921793,0.9253997227807821
4218,The Iron Orchard,204881,204881,0,movies-2019.csv,2019,1.0,0.0
4219,Working Woman,204727,64048,140679,movies-2019.csv,2019,0.3128458874501165,0.6871541125498835
4220,Hesburgh,204709,204709,0,movies-2019.csv,2019,1.0,0.0
4221,Pop Aye,204464,77976,126488,movies-2017.csv,2017,0.3813678691603412,0.6186321308396588
4222,Touchback,204232,204232,0,movies-2012.csv,2012,1.0,0.0
4223,Forrest Gump 2019 Re-release,203088,203088,0,movies-2019.csv,2019,1.0,0.0
4224,Charlie's Country,202966,42937,160029,movies-2014.csv,2014,0.2115477469132761,0.7884522530867238
4225,Keep the Change,202788,202788,0,movies-2018.csv,2018,1.0,0.0
4226,"Filth to Ashes, Flesh to Dust",202531,202531,0,movies-2011.csv,2011,1.0,0.0
4227,The Bolshoi Ballet: Live From Moscow - Coppélia,202217,202217,0,movies-2018.csv,2018,1.0,0.0
4228,"Hieronymus Bosch, Touched by the Devil",201907,172533,29374,movies-2016.csv,2016,0.8545171787010851,0.14548282129891485
4229,The Bad Batch,201890,180851,21039,movies-2017.csv,2017,0.8957897865174105,0.10421021348258953
4230,Blink of an Eye,201874,201874,0,movies-2019.csv,2019,1.0,0.0
4231,Zombi Child,200909,25878,175031,movies-2019.csv,2019,0.12880458316949464,0.8711954168305054
4232,Gemini,200340,200340,0,movies-2018.csv,2018,1.0,0.0
4233,White Girl,200242,200242,0,movies-2016.csv,2016,1.0,0.0
4234,No Place on Earth,200238,200238,0,movies-2013.csv,2013,1.0,0.0
4235,9/11,200229,170000,30229,movies-2017.csv,2017,0.8490278630967543,0.1509721369032458
4236,Listen Up Philip,200126,200126,0,movies-2014.csv,2014,1.0,0.0
4237,Cutie and the Boxer,200036,200036,0,movies-2013.csv,2013,1.0,0.0
4238,Rebel Without a Cause 2018 Re-release,199963,199963,0,movies-2018.csv,2018,1.0,0.0
4239,The Fallen Idol 2016 Re-release,199619,199619,0,movies-2016.csv,2016,1.0,0.0
4240,October Baby,199442,199442,0,movies-2011.csv,2011,1.0,0.0
4241,Friendsgiving Day #2,198869,198869,0,movies-2019.csv,2019,1.0,0.0
4242,Little Joe,198674,23862,174812,movies-2019.csv,2019,0.1201063048008295,0.8798936951991705
4243,The Warrior Queen of Jhansi,198544,177289,21255,movies-2019.csv,2019,0.8929456442904343,0.10705435570956563
4244,Ex Libris: New York Public Library,198239,158192,40047,movies-2017.csv,2017,0.7979862690994204,0.2020137309005796
4245,A Summer's Tale,198126,198126,0,movies-2014.csv,2014,1.0,0.0
4246,Whores' Glory,197932,31420,166512,movies-2011.csv,2011,0.1587413859305216,0.8412586140694784
4247,Pusher,197857,0,197857,movies-2012.csv,2012,0.0,1.0
4248,Madeline's Madeline,197309,185576,11733,movies-2018.csv,2018,0.9405348970396687,0.05946510296033126
4249,Have It All -The Movie,197142,197142,0,movies-2018.csv,2018,1.0,0.0
4250,Mom,195701,0,195701,movies-2017.csv,2017,0.0,1.0
4251,Boom for Real: The Late Teenage Years of Jean-Michel Basquiat,195517,166616,28901,movies-2018.csv,2018,0.8521816517233796,0.14781834827662044
4252,The Divine Order,195081,76277,118804,movies-2017.csv,2017,0.3910016864789498,0.6089983135210503
4253,Free Angela and All Political Prisoners,195005,194102,903,movies-2013.csv,2013,0.9953693495038589,0.004630650496141125
4254,Family,194601,194601,0,movies-2019.csv,2019,1.0,0.0
4255,Mr. Klein,193028,193028,0,movies-2019.csv,2019,1.0,0.0
4256,Claire's Camera,191980,83418,108562,movies-2018.csv,2018,0.4345140118762371,0.5654859881237629
4257,Harry Potter and the Deathly Hallows: Part 2 2018 Re-release,191886,181938,9948,movies-2018.csv,2018,0.9481567180513429,0.05184328194865701
4258,Past Life,191678,180099,11579,movies-2017.csv,2017,0.9395913980738531,0.06040860192614698
4259,Chalo Dilli,191185,94300,96885,movies-2011.csv,2011,0.4932395323900934,0.5067604676099067
4260,Digimon Adventure tri. Part 1: Reunion Domestic Release,190581,190581,0,movies-2016.csv,2016,1.0,0.0
4261,Code Black,190229,190229,0,movies-2014.csv,2014,1.0,0.0
4262,The Doors: Break On Thru - A Celebration Of Ray Manzarek,190160,190160,0,movies-2020.csv,2020,1.0,0.0
4263,The Divine Plan,190031,190031,0,movies-2019.csv,2019,1.0,0.0
4264,Java Heat,189739,1061,188678,movies-2013.csv,2013,0.0055918920200907565,0.9944081079799092
4265,Munna Michael,189105,99629,89476,movies-2017.csv,2017,0.5268448745405991,0.47315512545940086
4266,Harry Potter and the Goblet of Fire 2018 Re-release,188716,188716,0,movies-2018.csv,2018,1.0,0.0
4267,The Bolshoi Ballet: Live From Moscow - Don Quixote,187946,187946,0,movies-2018.csv,2018,1.0,0.0
4268,Never-Ending Man: Hayao Miyazaki,187320,187320,0,movies-2018.csv,2018,1.0,0.0
4269,The Last Days on Mars,187191,24084,163107,movies-2013.csv,2013,0.12866003173229482,0.8713399682677052
4270,In the Fog,186838,11894,174944,movies-2013.csv,2013,0.06365942688318223,0.9363405731168177
4271,Good for Nothing,186119,0,186119,movies-2012.csv,2012,0.0,1.0
4272,Twiceland,186078,52874,133204,movies-2018.csv,2018,0.28414965767043926,0.7158503423295607
4273,In the Basement,186036,3643,182393,movies-2014.csv,2014,0.019582231396073877,0.9804177686039262
4274,Britt-Marie Was Here,185794,36549,149245,movies-2019.csv,2019,0.19671787032950472,0.8032821296704953
4275,Buñuel in the Labyrinth of the Turtles,185675,36205,149470,movies-2019.csv,2019,0.19499124814864682,0.8050087518513531
4276,The Duke of Burgundy,185147,64521,120626,movies-2015.csv,2015,0.3484852576601295,0.6515147423398705
4277,Cobra Kai Premiere Event feat. The Karate Kid,185082,185082,0,movies-2018.csv,2018,1.0,0.0
4278,The Wolf of Snow Hollow,185026,185026,0,movies-2020.csv,2020,1.0,0.0
4279,Amigo,184705,184705,0,movies-2011.csv,2011,1.0,0.0
4280,To Dust,184495,184495,0,movies-2019.csv,2019,1.0,0.0
4281,Score,184025,101382,82643,movies-2017.csv,2017,0.5509142779513653,0.4490857220486347
4282,The River and the Wall,183602,183602,0,movies-2019.csv,2019,1.0,0.0
4283,"The Man Nobody Knew: In Search of My Father, CIA Spymaster William Colby",183342,183342,0,movies-2011.csv,2011,1.0,0.0
4284,Lambert & Stamp,183320,183320,0,movies-2015.csv,2015,1.0,0.0
4285,Whose Streets?,182799,182799,0,movies-2017.csv,2017,1.0,0.0
4286,The Masked Saint,182695,182695,0,movies-2016.csv,2016,1.0,0.0
4287,I Am Not A Witch,182462,50868,131594,movies-2017.csv,2017,0.2787868158849514,0.7212131841150486
4288,Shock and Awe,182415,77980,104435,movies-2018.csv,2018,0.42748677466217144,0.5725132253378286
4289,Giant Little Ones,181507,181507,0,movies-2019.csv,2019,1.0,0.0
4290,Bolshoi Ballet: Raymonda domestic,181361,181361,0,movies-2019.csv,2019,1.0,0.0
4291,Raymonda: Bolshoi Ballet,181361,181361,0,movies-2019.csv,2019,1.0,0.0
4292,Rafiki,181316,137968,43348,movies-2019.csv,2019,0.7609256767190982,0.23907432328090186
4293,Six Minutes to Midnight,181216,0,181216,movies-2020.csv,2020,0.0,1.0
4294,1001 Grams,181030,10983,170047,movies-2014.csv,2014,0.06066950229243772,0.9393304977075623
4295,An Honest Liar,180590,180590,0,movies-2015.csv,2015,1.0,0.0
4296,Fukrey,180331,125279,55052,movies-2013.csv,2013,0.694716937187727,0.30528306281227297
4297,Go for It!,180237,180237,0,movies-2011.csv,2011,1.0,0.0
4298,Lost Woods,180117,180117,0,movies-2012.csv,2012,1.0,0.0
4299,Lila & Eve,179807,38263,141544,movies-2015.csv,2015,0.21280039153091926,0.7871996084690808
4300,Offender,178158,0,178158,movies-2012.csv,2012,0.0,1.0
4301,Walking on Water,178119,102140,75979,movies-2019.csv,2019,0.5734368596275524,0.42656314037244764
4302,Modest Heroes,178027,178027,0,movies-2019.csv,2019,1.0,0.0
4303,Zaytoun,177753,42330,135423,movies-2013.csv,2013,0.2381394406845454,0.7618605593154546
4304,Monumental: In Search of America's National Treasure,177729,177729,0,movies-2012.csv,2012,1.0,0.0
4305,Billie,177602,0,177602,movies-2020.csv,2020,0.0,1.0
4306,People Places Things,177338,67046,110292,movies-2015.csv,2015,0.3780689981842583,0.6219310018157417
4307,Anita: Speaking Truth to Power,176979,176979,0,movies-2014.csv,2014,1.0,0.0
4308,Bye Bye Germany,176933,73730,103203,movies-2017.csv,2017,0.4167114105339309,0.5832885894660691
4309,Vigilante Diaries,176777,1991,174786,movies-2016.csv,2016,0.01126277739751212,0.9887372226024879
4310,"Iyengar: The Man, Yoga, and the Student's Journey",176387,176387,0,movies-2019.csv,2019,1.0,0.0
4311,Better Watch Out,176288,20369,155919,movies-2017.csv,2017,0.1155438827373389,0.884456117262661
4312,Girl on a Bicycle,176272,91401,84871,movies-2013.csv,2013,0.5185225106653354,0.4814774893346646
4313,Saint Judy,176196,78935,97261,movies-2019.csv,2019,0.4479954141978251,0.5520045858021748
4314,The Bolshoi Ballet: Live From Moscow - The Flames of Paris,175922,175922,0,movies-2018.csv,2018,1.0,0.0
4315,Afternoon Delight,175755,174496,1259,movies-2013.csv,2013,0.9928366191573497,0.00716338084265028
4316,Butter,175706,105018,70688,movies-2012.csv,2012,0.5976915984656187,0.4023084015343813
4317,A.C.O.D.,175705,175705,0,movies-2013.csv,2013,1.0,0.0
4318,Black Rock,175682,0,175682,movies-2013.csv,2013,0.0,1.0
4319,Champion,175232,175232,0,movies-2017.csv,2017,1.0,0.0
4320,Apparition,175038,0,175038,movies-2019.csv,2019,0.0,1.0
4321,Always at The Carlyle,174251,174251,0,movies-2018.csv,2018,1.0,0.0
4322,SOMM,174197,174197,0,movies-2013.csv,2013,1.0,0.0
4323,Grand Illusion,174065,174065,0,movies-2012.csv,2012,1.0,0.0
4324,Elf 2020 Re-release,173568,173568,0,movies-2020.csv,2020,1.0,0.0
4325,Neon Bull,173219,26734,146485,movies-2016.csv,2016,0.15433641806037443,0.8456635819396255
4326,Cirkus Columbia,173083,3457,169626,movies-2011.csv,2011,0.019973076500869526,0.9800269234991305
4327,Them That Follow,172952,159218,13734,movies-2019.csv,2019,0.9205906841204496,0.0794093158795504
4328,Bellflower,172935,168226,4709,movies-2011.csv,2011,0.9727701159395149,0.027229884060485154
4329,Afternoon of a Faun: Tanaquil Le Clercq,172450,172450,0,movies-2014.csv,2014,1.0,0.0
4330,All Things Must Pass,172394,172394,0,movies-2015.csv,2015,1.0,0.0
4331,Escape from Tomorrow,171962,171962,0,movies-2013.csv,2013,1.0,0.0
4332,Little Woods,171912,150010,21902,movies-2019.csv,2019,0.8725976080785518,0.12740239192144817
4333,Copperhead,171740,171740,0,movies-2013.csv,2013,1.0,0.0
4334,Abuse of Weakness,171660,31611,140049,movies-2014.csv,2014,0.1841488989863684,0.8158511010136316
4335,United Passions,171511,607,170904,movies-2014.csv,2014,0.003539131600888573,0.9964608683991114
4336,The Bolshoi Ballet: Live From Moscow - La Sylphide,171177,171177,0,movies-2018.csv,2018,1.0,0.0
4337,Palau the Movie,171155,134696,36459,movies-2019.csv,2019,0.786982559668137,0.21301744033186293
4338,Cheerful Weather for the Wedding,170922,2651,168271,movies-2012.csv,2012,0.015509998712863177,0.9844900012871368
4339,Apparition Hill,170457,170457,0,movies-2016.csv,2016,1.0,0.0
4340,The Human Centipede II (Full Sequence),170323,141877,28446,movies-2011.csv,2011,0.8329879112040065,0.1670120887959935
4341,The House That Jack Built,170113,170113,0,movies-2018.csv,2018,1.0,0.0
4342,The Fits,169236,166425,2811,movies-2016.csv,2016,0.9833900588527263,0.01660994114727363
4343,Viva Riva!,168982,61759,107223,movies-2011.csv,2011,0.3654767963451729,0.6345232036548272
4344,Free the Mind,168916,157201,11715,movies-2013.csv,2013,0.930646001562907,0.06935399843709299
4345,Girls of the Sun,168771,19712,149059,movies-2018.csv,2018,0.1167973170746159,0.8832026829253841
4346,Valley of Bones,168738,168738,0,movies-2017.csv,2017,1.0,0.0
4347,We Summon the Darkness,168473,60794,107679,movies-2020.csv,2020,0.36085307437987096,0.6391469256201291
4348,Be Natural: The Untold Story of Alice Guy-Blaché,168189,115804,52385,movies-2019.csv,2019,0.6885349220222488,0.31146507797775125
4349,De Palma,168045,165237,2808,movies-2016.csv,2016,0.9832901901276444,0.016709809872355617
4350,The Clovehitch Killer,167994,8208,159786,movies-2018.csv,2018,0.04885888781742205,0.9511411121825779
4351,The Bolshoi Ballet: Live From Moscow - The Lady of the Camellias,167991,167991,0,movies-2018.csv,2018,1.0,0.0
4352,The Comeback Trail,167818,0,167818,movies-2020.csv,2020,0.0,1.0
4353,Beauty and the Dogs,167723,8915,158808,movies-2017.csv,2017,0.05315311555362115,0.9468468844463789
4354,Is Genesis History? 2018 Re-release,166763,166763,0,movies-2018.csv,2018,1.0,0.0
4355,Grease 2020 Re-release,166123,102000,64123,movies-2020.csv,2020,0.6140028773860332,0.38599712261396674
4356,The Day After,166022,24746,141276,movies-2017.csv,2017,0.1490525352061775,0.8509474647938225
4357,Far From the Tree,166018,166018,0,movies-2018.csv,2018,1.0,0.0
4358,The Film Critic,165891,7358,158533,movies-2014.csv,2014,0.04435442549625959,0.9556455745037404
4359,Bright Ones,165627,165627,0,movies-2019.csv,2019,1.0,0.0
4360,2001: A Space Odyssey 2019 Re-release,165494,135370,30124,movies-2019.csv,2019,0.8179752740280615,0.18202472597193856
4361,Christmas Eve,164839,91302,73537,movies-2015.csv,2015,0.5538859129210927,0.4461140870789073
4362,Nas: Time Is Illmatic,164540,164540,0,movies-2014.csv,2014,1.0,0.0
4363,The Chambermaid,164531,86422,78109,movies-2019.csv,2019,0.525262716448572,0.474737283551428
4364,Eastern Boys,164290,16831,147459,movies-2014.csv,2014,0.10244689268975592,0.8975531073102441
4365,Lost & Found,164026,125173,38853,movies-2018.csv,2018,0.7631290161315889,0.2368709838684111
4366,Cruel Peter,163925,0,163925,movies-2020.csv,2020,0.0,1.0
4367,Keep on Keepin' On,163745,163745,0,movies-2014.csv,2014,1.0,0.0
4368,Narco Cultura,163690,145088,18602,movies-2013.csv,2013,0.88635836031523,0.11364163968477
4369,Halston,163446,151991,11455,movies-2019.csv,2019,0.9299156908091969,0.07008430919080308
4370,Walking Out,162445,101947,60498,movies-2017.csv,2017,0.6275785650527871,0.3724214349472129
4371,The Turin Horse,162088,56391,105697,movies-2011.csv,2011,0.34790360791668723,0.6520963920833127
4372,Road to Nowhere,161619,40294,121325,movies-2011.csv,2011,0.24931474640976617,0.7506852535902339
4373,The Samuel Project,161565,161565,0,movies-2018.csv,2018,1.0,0.0
4374,Lu Over the Wall,161253,109857,51396,movies-2018.csv,2018,0.6812710461200722,0.31872895387992783
4375,Tharlo,161229,17091,144138,movies-2016.csv,2016,0.10600450291200715,0.8939954970879929
4376,"Diana Ross: Her Life, Love and Legacy",160968,160968,0,movies-2019.csv,2019,1.0,0.0
4377,National Theatre Live: The Curious Incident of the Dog in the Night-Time 2018 Re-release,160381,160381,0,movies-2018.csv,2018,1.0,0.0
4378,Beauty and the Beast 2016 Re-release,160215,160215,0,movies-2016.csv,2016,1.0,0.0
4379,Halloween 2020 Re-release,160000,160000,0,movies-2020.csv,2020,1.0,0.0
4380,Sinbad: The Fifth Voyage,159862,159862,0,movies-2014.csv,2014,1.0,0.0
4381,Murder 3,159798,0,159798,movies-2013.csv,2013,0.0,1.0
4382,The Model,159743,0,159743,movies-2016.csv,2016,0.0,1.0
4383,Eames: The Architect & The Painter,159715,153088,6627,movies-2011.csv,2011,0.9585073412015152,0.0414926587984848
4384,The Body,159317,68196,91121,movies-2019.csv,2019,0.42805224803379427,0.5719477519662057
4385,The Witness,159305,159305,0,movies-2016.csv,2016,1.0,0.0
4386,We Are What We Are,159047,81381,77666,movies-2013.csv,2013,0.5116789376725119,0.4883210623274881
4387,Until Forever,158872,35839,123033,movies-2016.csv,2016,0.2255841180321265,0.7744158819678735
4388,The Last Resort,158646,158646,0,movies-2018.csv,2018,1.0,0.0
4389,The Big Picture 2012 Re-release,158411,158411,0,movies-2012.csv,2012,1.0,0.0
4390,Mother of George,157937,157937,0,movies-2013.csv,2013,1.0,0.0
4391,The Look of Silence,157857,109089,48768,movies-2015.csv,2015,0.6910621638571619,0.30893783614283815
4392,Crazy Horse,157782,157782,0,movies-2012.csv,2012,1.0,0.0
4393,Hell and Back,157768,157768,0,movies-2015.csv,2015,1.0,0.0
4394,A Call to Spy,157736,151929,5807,movies-2020.csv,2020,0.9631853223106963,0.036814677689303646
4395,Chasing Madoff,157612,157612,0,movies-2011.csv,2011,1.0,0.0
4396,Eva Hesse,157481,157481,0,movies-2016.csv,2016,1.0,0.0
4397,The Booksellers,157383,25694,131689,movies-2020.csv,2020,0.16325778514833242,0.8367422148516676
4398,Suntan,157267,6643,150624,movies-2016.csv,2016,0.042240266553059444,0.9577597334469405
4399,LUV,156996,156996,0,movies-2013.csv,2013,1.0,0.0
4400,Marina Abramovic: The Artist Is Present,156695,86637,70058,movies-2012.csv,2012,0.5529021347203166,0.4470978652796835
4401,Deadtime,156072,156072,0,movies-2012.csv,2012,1.0,0.0
4402,Queen & Country,155881,41297,114584,movies-2015.csv,2015,0.26492645030504036,0.7350735496949596
4403,Money,155732,155732,0,movies-2019.csv,2019,1.0,0.0
4404,The Forgiveness of Blood,155383,126700,28683,movies-2012.csv,2012,0.8154045165816081,0.18459548341839196
4405,Western,155215,41072,114143,movies-2018.csv,2018,0.2646136004896434,0.7353863995103566
4406,The Boy and the World 2015 Re-release,155215,129480,25735,movies-2015.csv,2015,0.8341977257352704,0.16580227426472957
4407,Magic Trip: Ken Kesey's Search for a Kool Place,155005,154521,484,movies-2011.csv,2011,0.9968775200799974,0.0031224799200025807
4408,Bad Reputation,154190,148568,5622,movies-2018.csv,2018,0.963538491471561,0.03646150852843894
4409,Eating Animals,153993,149614,4379,movies-2018.csv,2018,0.9715636425032307,0.028436357496769333
4410,Citizen Koch,153908,153908,0,movies-2014.csv,2014,1.0,0.0
4411,The Tag Along: Devil Fish,153895,20726,133169,movies-2018.csv,2018,0.13467624029370676,0.8653237597062933
4412,Love Story 50th Anniversary,153504,153504,0,movies-2020.csv,2020,1.0,0.0
4413,Harmonium,153283,17191,136092,movies-2017.csv,2017,0.11215203251502123,0.8878479674849787
4414,Backstreet Boys: Show 'Em What You're Made Of,153068,153068,0,movies-2015.csv,2015,1.0,0.0
4415,I Am Woman,152987,0,152987,movies-2020.csv,2020,0.0,1.0
4416,In the Shadow of Women,152802,50291,102511,movies-2015.csv,2015,0.329125273229408,0.670874726770592
4417,Deceptive Practice: The Mysteries and Mentors of Ricky Jay,152791,152791,0,movies-2013.csv,2013,1.0,0.0
4418,Finding Fela,152346,120980,31366,movies-2014.csv,2014,0.7941133997610702,0.2058866002389298
4419,The Call Up,152294,0,152294,movies-2016.csv,2016,0.0,1.0
4420,Snake & Mongoose,152200,152200,0,movies-2013.csv,2013,1.0,0.0
4421,One Week and a Day,152178,41614,110564,movies-2016.csv,2016,0.2734560843223068,0.7265439156776933
4422,"Buttons, A New Musical Film",151983,151983,0,movies-2018.csv,2018,1.0,0.0
4423,Born to Be Blue,151926,151926,0,movies-2016.csv,2016,1.0,0.0
4424,Lupin the 3rd: Castle of Cagliostro 2017 Re-release,151802,142425,9377,movies-2017.csv,2017,0.9382287453393235,0.06177125466067641
4425,Generation Found,151751,151751,0,movies-2016.csv,2016,1.0,0.0
4426,Before You Know It,151507,151507,0,movies-2019.csv,2019,1.0,0.0
4427,Jay Myself,151331,151331,0,movies-2019.csv,2019,1.0,0.0
4428,Revenge of the Electric Car,151272,150886,386,movies-2011.csv,2011,0.9974483050399281,0.0025516949600719236
4429,Glory 2019 Re-release,150801,150801,0,movies-2019.csv,2019,1.0,0.0
4430,Tasting Menu,150718,18686,132032,movies-2013.csv,2013,0.12397988296023037,0.8760201170397697
4431,Kicks,150191,150191,0,movies-2016.csv,2016,1.0,0.0
4432,Godzilla 2014 Re-release,150191,150191,0,movies-2014.csv,2014,1.0,0.0
4433,Nobody Else But You,150173,43040,107133,movies-2011.csv,2011,0.28660278478821094,0.7133972152117891
4434,Piercing,149211,15856,133355,movies-2019.csv,2019,0.10626562384810771,0.8937343761518923
4435,Michael Moore in TrumpLand,149090,149090,0,movies-2016.csv,2016,1.0,0.0
4436,Gun Hill Road,148994,148994,0,movies-2011.csv,2011,1.0,0.0
4437,From Afar,148630,30169,118461,movies-2016.csv,2016,0.2029805557424477,0.7970194442575523
4438,Trial by Fire,148504,148504,0,movies-2019.csv,2019,1.0,0.0
4439,War and Peace,148503,148503,0,movies-2019.csv,2019,1.0,0.0
4440,Restless Creature: Wendy Whelan,147780,147780,0,movies-2017.csv,2017,1.0,0.0
4441,Night of the Living Dead 2018 Re-release,147423,147423,0,movies-2018.csv,2018,1.0,0.0
4442,Driven,147172,0,147172,movies-2019.csv,2019,0.0,1.0
4443,Songs My Brothers Taught Me,146937,34793,112144,movies-2015.csv,2015,0.23678855563949175,0.7632114443605083
4444,American Promise,146702,146702,0,movies-2013.csv,2013,1.0,0.0
4445,Watermark,146572,84464,62108,movies-2014.csv,2014,0.576262860573643,0.423737139426357
4446,Touched with Fire,146487,146487,0,movies-2016.csv,2016,1.0,0.0
4447,5 Broken Cameras,146475,109983,36492,movies-2012.csv,2012,0.7508653353814644,0.2491346646185356
4448,Hannah,146325,11700,134625,movies-2018.csv,2018,0.07995899538698104,0.920041004613019
4449,Starlet,146222,88212,58010,movies-2012.csv,2012,0.6032744730615092,0.3967255269384908
4450,Deadly Renovations,146146,146146,0,movies-2012.csv,2012,1.0,0.0
4451,The Punk Singer,146000,122742,23258,movies-2013.csv,2013,0.8406986301369863,0.1593013698630137
4452,Citizen K,145941,120411,25530,movies-2019.csv,2019,0.8250662939132938,0.17493370608670628
4453,Framing John DeLorean,145625,145625,0,movies-2019.csv,2019,1.0,0.0
4454,The Last Dalai Lama?,145524,145524,0,movies-2017.csv,2017,1.0,0.0
4455,Krisha,144822,144822,0,movies-2016.csv,2016,1.0,0.0
4456,Mr. Smith Goes to Washington 2018 Re-release,144738,144738,0,movies-2018.csv,2018,1.0,0.0
4457,Wendy,144564,143518,1046,movies-2020.csv,2020,0.992764450347251,0.0072355496527489556
4458,Irving Berlin's Holiday Inn The Broadway Musical,144550,144550,0,movies-2017.csv,2017,1.0,0.0
4459,The Price of Everything,144446,87400,57046,movies-2018.csv,2018,0.6050704069340792,0.39492959306592085
4460,Yellow Day 2015 Re-release,144163,144163,0,movies-2015.csv,2015,1.0,0.0
4461,From Beneath,144123,144123,0,movies-2012.csv,2012,1.0,0.0
4462,Cold Weather,144056,141358,2698,movies-2011.csv,2011,0.9812711723218748,0.018728827678125174
4463,Thunder Soul,143986,143986,0,movies-2011.csv,2011,1.0,0.0
4464,Cop Car,143658,134552,9106,movies-2015.csv,2015,0.9366133455846525,0.06338665441534756
4465,Dirty Girl,143485,55125,88360,movies-2011.csv,2011,0.38418650033104507,0.6158134996689549
4466,Doctor Who: Logopolis,143248,143248,0,movies-2019.csv,2019,1.0,0.0
4467,Alpeis,143234,16057,127177,movies-2012.csv,2012,0.1121032715695994,0.8878967284304006
4468,Kids for Cash,143178,143178,0,movies-2014.csv,2014,1.0,0.0
4469,Clash,143121,18215,124906,movies-2016.csv,2016,0.12726993243479293,0.8727300675652071
4470,Disguising,143108,0,143108,movies-2018.csv,2018,0.0,1.0
4471,Dragon 2012 Re-release,142029,11137,130892,movies-2012.csv,2012,0.0784135634271874,0.9215864365728126
4472,John Dies at the End,141951,141951,0,movies-2013.csv,2013,1.0,0.0
4473,Citadel,141886,13377,128509,movies-2012.csv,2012,0.09427991486122662,0.9057200851387733
4474,May in the Summer,141605,22004,119601,movies-2014.csv,2014,0.15538999329119735,0.8446100067088027
4475,Best F(r)iends Volume Two,141524,141524,0,movies-2018.csv,2018,1.0,0.0
4476,The Silencing,141479,100746,40733,movies-2020.csv,2020,0.7120915471554082,0.28790845284459177
4477,Fatman,141235,141235,0,movies-2020.csv,2020,1.0,0.0
4478,Branagh Theatre Live: The Winter's Tale,141143,141143,0,movies-2019.csv,2019,1.0,0.0
4479,Metropolis Giorgio Moroder Presents,140907,27362,113545,movies-2011.csv,2011,0.19418481693599324,0.8058151830640068
4480,Canelo vs. Kovalev,140820,140820,0,movies-2019.csv,2019,1.0,0.0
4481,The Cordillera of Dreams,140465,20943,119522,movies-2019.csv,2019,0.14909763998149006,0.8509023600185099
4482,Incitement,140306,140306,0,movies-2020.csv,2020,1.0,0.0
4483,Gore Vidal: The United States of Amnesia,140164,140164,0,movies-2014.csv,2014,1.0,0.0
4484,Beautiful Boy,140123,77247,62876,movies-2011.csv,2011,0.5512799469037917,0.4487200530962083
4485,Liv & Ingmar,140041,10347,129694,movies-2012.csv,2012,0.07388550495926192,0.9261144950407381
4486,Coherence,139745,102617,37128,movies-2014.csv,2014,0.7343160757093277,0.2656839242906723
4487,Hunky Dory,139653,20296,119357,movies-2012.csv,2012,0.14533164343050275,0.8546683565694972
4488,Support the Girls,139550,129124,10426,movies-2018.csv,2018,0.9252884270870656,0.07471157291293443
4489,Flowers,139421,61568,77853,movies-2014.csv,2014,0.44159775069752766,0.5584022493024724
4490,Wilder vs. Ortiz,139207,139207,0,movies-2019.csv,2019,1.0,0.0
4491,Xenia,139186,3181,136005,movies-2014.csv,2014,0.02285431005991982,0.9771456899400802
4492,The Polar Express 2014 IMAX Release,139055,139055,0,movies-2014.csv,2014,1.0,0.0
4493,Who Will Write Our History,138868,138039,829,movies-2019.csv,2019,0.9940303021574445,0.0059696978425555205
4494,Head Full of Honey,138844,12350,126494,movies-2018.csv,2018,0.0889487482354297,0.9110512517645704
4495,Good Ol' Freda,138811,138811,0,movies-2013.csv,2013,1.0,0.0
4496,Zero Motivation,138609,116044,22565,movies-2014.csv,2014,0.8372039333665202,0.16279606663347979
4497,The Brawler,138515,75929,62586,movies-2018.csv,2018,0.548164458722882,0.451835541277118
4498,Psycho-Pass: The Movie,138366,138366,0,movies-2016.csv,2016,1.0,0.0
4499,Most Wanted,138000,138000,0,movies-2020.csv,2020,1.0,0.0
4500,Lynryd Skynyrd: Last of the Street Survivors Farewell Tour,137888,137888,0,movies-2019.csv,2019,1.0,0.0
4501,Beneath Us,137260,137260,0,movies-2020.csv,2020,1.0,0.0
4502,Is the Man Who Is Tall Happy?,137042,137042,0,movies-2013.csv,2013,1.0,0.0
4503,Slaughter Creek,136815,136815,0,movies-2012.csv,2012,1.0,0.0
4504,Made in Abyss: Journey's Dawn,135821,134047,1774,movies-2019.csv,2019,0.9869386913658418,0.013061308634158194
4505,I Will Follow,135809,135809,0,movies-2011.csv,2011,1.0,0.0
4506,Mantra: Sounds Into Silence,135684,115013,20671,movies-2018.csv,2018,0.8476533710680699,0.15234662893193007
4507,Skin,135562,0,135562,movies-2019.csv,2019,0.0,1.0
4508,Sonchiriya,135413,86765,48648,movies-2019.csv,2019,0.6407435032087022,0.35925649679129773
4509,La Sapienza,135392,135392,0,movies-2015.csv,2015,1.0,0.0
4510,The Kind Words,135382,135382,0,movies-2016.csv,2016,1.0,0.0
4511,The Other Dream Team,135228,135228,0,movies-2012.csv,2012,1.0,0.0
4512,The Other Story,135191,135191,0,movies-2019.csv,2019,1.0,0.0
4513,The Bolshoi Ballet: Live From Moscow - A Hero of Our Time,135168,104837,30331,movies-2017.csv,2017,0.7756051728219697,0.2243948271780303
4514,My Neighbor Totoro 2015 Re-release,134877,0,134877,movies-2015.csv,2015,0.0,1.0
4515,Another Day of Life,134801,3190,131611,movies-2018.csv,2018,0.023664512874533573,0.9763354871254665
4516,Led Zeppelin: Celebration Day,134753,0,134753,movies-2012.csv,2012,0.0,1.0
4517,The Times of Bill Cunningham,134288,134288,0,movies-2020.csv,2020,1.0,0.0
4518,Ism,134165,134165,0,movies-2016.csv,2016,1.0,0.0
4519,Redwood Highway,134049,134049,0,movies-2014.csv,2014,1.0,0.0
4520,The Great Museum,133905,18020,115885,movies-2014.csv,2014,0.13457301818453382,0.8654269818154662
4521,Don't Think I've Forgotten: Cambodia's Lost Rock and Roll,133443,133443,0,movies-2015.csv,2015,1.0,0.0
4522,Under the Shadow,133324,31900,101424,movies-2016.csv,2016,0.23926674867240708,0.760733251327593
4523,The Jewish Cardinal,133232,133232,0,movies-2014.csv,2014,1.0,0.0
4524,"Hare Krishna! The Mantra, the Movement and the Swami Who Started It",133006,133006,0,movies-2017.csv,2017,1.0,0.0
4525,Tonight You're Mine,132787,6255,126532,movies-2011.csv,2011,0.04710551484708594,0.9528944851529141
4526,Dawson City: Frozen Time,132369,132369,0,movies-2016.csv,2016,1.0,0.0
4527,Kumaré,132160,132160,0,movies-2012.csv,2012,1.0,0.0
4528,My Brother the Devil,132056,44906,87150,movies-2012.csv,2012,0.34005270491306716,0.6599472950869328
4529,How to Survive a Plague,132055,132055,0,movies-2012.csv,2012,1.0,0.0
4530,A Ballerina's Tale,131995,131995,0,movies-2015.csv,2015,1.0,0.0
4531,Mugamoodi,131965,101000,30965,movies-2012.csv,2012,0.7653544500435722,0.23464554995642783
4532,28 Hotel Rooms,131208,18869,112339,movies-2012.csv,2012,0.1438098286689836,0.8561901713310164
4533,Rudy 2018 Re-release,131200,131200,0,movies-2018.csv,2018,1.0,0.0
4534,The Wind,130974,28252,102722,movies-2019.csv,2019,0.21570693420068104,0.7842930657993189
4535,Mister America,130897,130897,0,movies-2019.csv,2019,1.0,0.0
4536,The Image Book,130802,94153,36649,movies-2018.csv,2018,0.7198131527040871,0.2801868472959129
4537,Five Seasons: The Gardens of Piet Oudolf,130319,119223,11096,movies-2018.csv,2018,0.9148550863649967,0.08514491363500334
4538,Requiem for the American Dream,130152,130152,0,movies-2016.csv,2016,1.0,0.0
4539,Harry Potter and the Half-Blood Prince 2018 Re-release,130081,130081,0,movies-2018.csv,2018,1.0,0.0
4540,Section 375,129916,0,129916,movies-2019.csv,2019,0.0,1.0
4541,The Fairy,129818,38399,91419,movies-2011.csv,2011,0.2957910305196506,0.7042089694803494
4542,Great Performances at the Met: Puccini: Madama Butterfly,129730,129730,0,movies-2018.csv,2018,1.0,0.0
4543,Great Performances at the Met: Tchaikovsky: Eugene Onegin 2018 Re-release,129498,129498,0,movies-2018.csv,2018,1.0,0.0
4544,Great Performances at the Met: Verdi: Il Trovatore,129393,129393,0,movies-2018.csv,2018,1.0,0.0
4545,I Called Him Morgan,128986,128986,0,movies-2017.csv,2017,1.0,0.0
4546,Yossi,128668,117047,11621,movies-2012.csv,2012,0.9096822830851494,0.09031771691485062
4547,Love After Love,128602,121098,7504,movies-2018.csv,2018,0.9416494300244164,0.058350569975583584
4548,The Adventurer: The Curse of the Midas Box,128471,6399,122072,movies-2014.csv,2014,0.04980890629013552,0.9501910937098644
4549,Where Hands Touch,128269,67743,60526,movies-2018.csv,2018,0.5281322844958641,0.47186771550413587
4550,Computer Chess,127852,102041,25811,movies-2013.csv,2013,0.7981181365954385,0.20188186340456152
4551,Steve Jobs: The Lost Interview,127541,105710,21831,movies-2011.csv,2011,0.8288315130036615,0.17116848699633844
4552,Sleepless in Seattle 2018 Re-release,127281,127281,0,movies-2018.csv,2018,1.0,0.0
4553,A Band Called Death,127257,127257,0,movies-2013.csv,2013,1.0,0.0
4554,Chimes at Midnight,126724,126724,0,movies-2016.csv,2016,1.0,0.0
4555,Silent Night,126594,14567,112027,movies-2012.csv,2012,0.11506864464350601,0.884931355356494
4556,Escape Fire: The Fight to Rescue American Healthcare,126238,126238,0,movies-2012.csv,2012,1.0,0.0
4557,Lucky Grandma,126169,102000,24169,movies-2020.csv,2020,0.8084394740387892,0.19156052596121076
4558,The Great Buster,125807,118344,7463,movies-2018.csv,2018,0.9406789765275382,0.059321023472461785
4559,Europa Report,125687,125687,0,movies-2013.csv,2013,1.0,0.0
4560,Paris Is Burning 2019 Re-release,125677,125677,0,movies-2019.csv,2019,1.0,0.0
4561,Only,125603,0,125603,movies-2020.csv,2020,0.0,1.0
4562,This Changes Everything,125348,64988,60360,movies-2019.csv,2019,0.5184606056738041,0.48153939432619586
4563,Rosie,125319,6839,118480,movies-2019.csv,2019,0.05457273039203951,0.9454272696079605
4564,The B-Side: Elsa Dorfman's Portrait Photography,125227,125227,0,movies-2017.csv,2017,1.0,0.0
4565,Spinning Plates,124856,112449,12407,movies-2013.csv,2013,0.9006295252130454,0.09937047478695457
4566,Mary Magdalene 2019 Re-release,124741,124741,0,movies-2019.csv,2019,1.0,0.0
4567,Every Secret Thing,124733,103536,21197,movies-2015.csv,2015,0.8300610103180394,0.16993898968196067
4568,Hymn: Sarah Brightman in Concert,124707,113274,11433,movies-2018.csv,2018,0.9083211046693449,0.09167889533065506
4569,A Tuba to Cuba,124592,121772,2820,movies-2019.csv,2019,0.9773661230255554,0.022633876974444588
4570,'85: The Greatest Team in Football History,124573,124573,0,movies-2018.csv,2018,1.0,0.0
4571,Final: The Rapture,124561,124561,0,movies-2013.csv,2013,1.0,0.0
4572,Vidal Sassoon: The Movie,124532,85974,38558,movies-2011.csv,2011,0.6903767706292359,0.30962322937076414
4573,Post Tenebras Lux,124279,39185,85094,movies-2012.csv,2012,0.31529864257034573,0.6847013574296542
4574,The Square,124244,124244,0,movies-2013.csv,2013,1.0,0.0
4575,Marguerite & Julien,123918,0,123918,movies-2015.csv,2015,0.0,1.0
4576,Knights of Badassdom,123854,123854,0,movies-2014.csv,2014,1.0,0.0
4577,Wings of Desire 2018 Re-release,123830,123830,0,movies-2018.csv,2018,1.0,0.0
4578,The Magic of Belle Isle,123821,102388,21433,movies-2012.csv,2012,0.8269033524200257,0.1730966475799743
4579,Puncture,123700,68945,54755,movies-2011.csv,2011,0.5573565076798707,0.44264349232012934
4580,Appropriate Behavior,123699,46912,76787,movies-2015.csv,2015,0.37924316283882653,0.6207568371611735
4581,Sigur Rós: Inni,123482,123482,0,movies-2011.csv,2011,1.0,0.0
4582,Downtown 81 2019 Re-release,123387,123387,0,movies-2019.csv,2019,1.0,0.0
4583,Easy Rider 2019 Re-release,123276,123276,0,movies-2019.csv,2019,1.0,0.0
4584,The Last Mountain,122961,122961,0,movies-2011.csv,2011,1.0,0.0
4585,Ashby,122919,4631,118288,movies-2015.csv,2015,0.03767521701282959,0.9623247829871704
4586,Blood Fest,122833,82774,40059,movies-2018.csv,2018,0.6738742845977872,0.32612571540221275
4587,"14 Days, 12 Nights",122806,122530,276,movies-2020.csv,2020,0.9977525528068661,0.002247447193133886
4588,Do I Sound Gay?,122595,119388,3207,movies-2015.csv,2015,0.9738406949712468,0.026159305028753212
4589,Tragedy Girls,122211,61899,60312,movies-2017.csv,2017,0.506492868890689,0.49350713110931094
4590,The Ones Below,121827,12488,109339,movies-2016.csv,2016,0.10250601262445927,0.8974939873755408
4591,Tremors,121813,23911,97902,movies-2019.csv,2019,0.19629267812138276,0.8037073218786173
4592,Yu-Gi-Oh!: The Movie - Pyramid of Light 2018 Re-release,121688,121688,0,movies-2018.csv,2018,1.0,0.0
4593,Letters to Elena,121254,8511,112743,movies-2012.csv,2012,0.07019149883715177,0.9298085011628482
4594,Afflicted,121179,121179,0,movies-2014.csv,2014,1.0,0.0
4595,In Jackson Heights,121094,121094,0,movies-2015.csv,2015,1.0,0.0
4596,Michael,121034,15715,105319,movies-2011.csv,2011,0.12983954921757523,0.8701604507824248
4597,The Girl Without Hands,121020,21787,99233,movies-2016.csv,2016,0.1800280945298298,0.8199719054701702
4598,Miss Sharon Jones!,120880,120880,0,movies-2016.csv,2016,1.0,0.0
4599,Better Living Through Chemistry,120823,75143,45680,movies-2014.csv,2014,0.6219262888688412,0.3780737111311588
4600,Hockney 2016 Re-release,120745,120745,0,movies-2016.csv,2016,1.0,0.0
4601,Cowgirls 'n Angels,120680,120680,0,movies-2012.csv,2012,1.0,0.0
4602,Spark: A Burning Man Story,120459,120459,0,movies-2013.csv,2013,1.0,0.0
4603,Foodfight!,120141,0,120141,movies-2012.csv,2012,0.0,1.0
4604,Blank City,119929,116037,3892,movies-2011.csv,2011,0.9675474655838038,0.03245253441619625
4605,Avant qu'on explose,119894,119894,0,movies-2019.csv,2019,1.0,0.0
4606,The Pearl Button,119753,42166,77587,movies-2015.csv,2015,0.35210808915016745,0.6478919108498326
4607,Digging for Fire,119364,119364,0,movies-2015.csv,2015,1.0,0.0
4608,Remember the Goal,119100,119100,0,movies-2016.csv,2016,1.0,0.0
4609,Until Forever 2016 Re-release,118795,105358,13437,movies-2016.csv,2016,0.8868891788374932,0.11311082116250684
4610,Neither Heaven Nor Earth,118663,12810,105853,movies-2015.csv,2015,0.10795277382166303,0.892047226178337
4611,The Levelling,118451,3040,115411,movies-2017.csv,2017,0.025664620813669787,0.9743353791863302
4612,Styx,118188,70794,47394,movies-2018.csv,2018,0.5989948218093207,0.40100517819067927
4613,Come to Daddy,117947,96713,21234,movies-2020.csv,2020,0.8199699865193689,0.18003001348063113
4614,Victor,117755,117755,0,movies-2016.csv,2016,1.0,0.0
4615,The Decoy Bride,117754,759,116995,movies-2011.csv,2011,0.006445640912410619,0.9935543590875894
4616,Bisbee '17,117470,117470,0,movies-2018.csv,2018,1.0,0.0
4617,George Takei's Allegiance 2018 Re-release,117162,117162,0,movies-2018.csv,2018,1.0,0.0
4618,Jauja 2014 Re-release,117117,60231,56886,movies-2014.csv,2014,0.5142805912036681,0.48571940879633185
4619,Gimme the Loot,116783,104442,12341,movies-2013.csv,2013,0.8943253726997936,0.10567462730020637
4620,A Case of You,116559,4187,112372,movies-2013.csv,2013,0.035921722046345625,0.9640782779536544
4621,The Undefeated,116381,116381,0,movies-2011.csv,2011,1.0,0.0
4622,The Art of Flight,116134,0,116134,movies-2012.csv,2012,0.0,1.0
4623,Mob Psycho 100,115766,115766,0,movies-2019.csv,2019,1.0,0.0
4624,I Am Divine,115739,81497,34242,movies-2013.csv,2013,0.7041446703358418,0.2958553296641582
4625,Headshot,115511,1373,114138,movies-2011.csv,2011,0.011886313857554691,0.9881136861424453
4626,Caged No More,114959,114959,0,movies-2016.csv,2016,1.0,0.0
4627,Nostalgia,114603,114603,0,movies-2018.csv,2018,1.0,0.0
4628,Sympathy for the Devil,114301,51150,63151,movies-2019.csv,2019,0.44750264652102784,0.5524973534789722
4629,John McEnroe: In the Realm of Perfection,114289,90964,23325,movies-2018.csv,2018,0.795912117526621,0.2040878824733789
4630,Ain't in It for My Health: A Film About Levon Helm,113966,113966,0,movies-2013.csv,2013,1.0,0.0
4631,Bodied,113956,113956,0,movies-2018.csv,2018,1.0,0.0
4632,The Woman Who Loves Giraffes,113858,113858,0,movies-2019.csv,2019,1.0,0.0
4633,35 and Ticking,113794,113794,0,movies-2011.csv,2011,1.0,0.0
4634,The Goonies 2015 Re-release,113538,113538,0,movies-2015.csv,2015,1.0,0.0
4635,"We Love You, Sally Carmichael!",113435,113435,0,movies-2017.csv,2017,1.0,0.0
4636,Abacus: Small Enough to Jail,113278,113278,0,movies-2017.csv,2017,1.0,0.0
4637,God the Father,113276,113276,0,movies-2014.csv,2014,1.0,0.0
4638,Burn 2012 Re-release,113173,113173,0,movies-2012.csv,2012,1.0,0.0
4639,Road Hard,113169,113169,0,movies-2015.csv,2015,1.0,0.0
4640,Police Story,113164,113164,0,movies-2019.csv,2019,1.0,0.0
4641,Filmworker,112828,102609,10219,movies-2018.csv,2018,0.9094285106533839,0.09057148934661609
4642,Follow Me: The Yoni Netanyahu Story,112679,112679,0,movies-2012.csv,2012,1.0,0.0
4643,A Boy. A Girl. A Dream.,112552,112552,0,movies-2018.csv,2018,1.0,0.0
4644,The Recall,112357,22943,89414,movies-2017.csv,2017,0.20419733527951084,0.7958026647204891
4645,"Hale County This Morning, This Evening",112282,112282,0,movies-2018.csv,2018,1.0,0.0
4646,The Dawn Wall,112191,112191,0,movies-2018.csv,2018,1.0,0.0
4647,Penton: The John Penton Story,112159,112159,0,movies-2014.csv,2014,1.0,0.0
4648,How Viktor 'The Garlic' Took Alexey 'The Stud' to the Nursing Home,112071,12954,99117,movies-2017.csv,2017,0.11558744010493348,0.8844125598950665
4649,A Chance in the World,112007,112007,0,movies-2018.csv,2018,1.0,0.0
4650,Una noche,111903,100887,11016,movies-2013.csv,2013,0.9015575989919842,0.09844240100801586
4651,1915,111682,111682,0,movies-2015.csv,2015,1.0,0.0
4652,Rich Hill,111376,111376,0,movies-2014.csv,2014,1.0,0.0
4653,Elevator to the Gallows 2016 Re-release,111267,111267,0,movies-2016.csv,2016,1.0,0.0
4654,Heaven,111232,111232,0,movies-2020.csv,2020,1.0,0.0
4655,"Wild Horse, Wild Ride",111205,111205,0,movies-2012.csv,2012,1.0,0.0
4656,A Paris Education,111197,21598,89599,movies-2018.csv,2018,0.19423185877316834,0.8057681412268317
4657,Strangerland,111107,17472,93635,movies-2015.csv,2015,0.15725381839128047,0.8427461816087195
4658,The Obama Effect,110904,110904,0,movies-2012.csv,2012,1.0,0.0
4659,The Overnighters,110763,110763,0,movies-2014.csv,2014,1.0,0.0
4660,Duran Duran: Unstaged,110746,110746,0,movies-2014.csv,2014,1.0,0.0
4661,The Perfect Family,110313,110313,0,movies-2012.csv,2012,1.0,0.0
4662,The Trouble with Terkel,110289,110289,0,movies-2017.csv,2017,1.0,0.0
4663,Roar,110048,110048,0,movies-2015.csv,2015,1.0,0.0
4664,The Fifth Element 2017 Re-release,109786,0,109786,movies-2017.csv,2017,0.0,1.0
4665,Babylon,109749,109749,0,movies-2019.csv,2019,1.0,0.0
4666,Zero Days,109649,109649,0,movies-2016.csv,2016,1.0,0.0
4667,Anohana the Movie: The Flower We Saw That Day (Ano hi mita hana no namae wo bokutachi wa mada shiran,109630,109630,0,movies-2014.csv,2014,1.0,0.0
4668,Cameraperson,109464,102033,7431,movies-2016.csv,2016,0.9321146678360008,0.06788533216399913
4669,Wedding Party 2,109459,11140,98319,movies-2017.csv,2017,0.10177326670260098,0.898226733297399
4670,The Lure,108846,101657,7189,movies-2017.csv,2017,0.9339525568234018,0.06604744317659814
4671,Adult Beginners,108808,108808,0,movies-2015.csv,2015,1.0,0.0
4672,Sworn Virgin,108681,4636,104045,movies-2015.csv,2015,0.042656950156881146,0.9573430498431188
4673,Red Sorghum,108371,0,108371,movies-2018.csv,2018,0.0,1.0
4674,Violet & Daisy,108139,17186,90953,movies-2013.csv,2013,0.15892508715634507,0.8410749128436549
4675,Bettie Page Reveals All,108118,108118,0,movies-2013.csv,2013,1.0,0.0
4676,"Love, Cecil",107940,106057,1883,movies-2017.csv,2017,0.9825551232166018,0.017444876783398185
4677,Kidnapping of Michel Houellebecq,107641,11546,96095,movies-2014.csv,2014,0.10726396075844706,0.892736039241553
4678,Revenge of the Green Dragons,107412,0,107412,movies-2014.csv,2014,0.0,1.0
4679,"No Date, No Signature",107368,36444,70924,movies-2018.csv,2018,0.3394307428656583,0.6605692571343417
4680,Cockneys vs Zombies,107348,0,107348,movies-2012.csv,2012,0.0,1.0
4681,National Theatre Live: Julius Caesar,107057,107057,0,movies-2018.csv,2018,1.0,0.0
4682,Jeruzalem,107024,11287,95737,movies-2016.csv,2016,0.10546232620720586,0.8945376737927941
4683,Best Worst Thing That Ever Could Have Happened,106986,106986,0,movies-2016.csv,2016,1.0,0.0
4684,The Tales of Hoffmann,106860,91930,14930,movies-2015.csv,2015,0.8602844843720756,0.1397155156279244
4685,Ivory Tower,106771,106771,0,movies-2014.csv,2014,1.0,0.0
4686,Vita Activa: The Spirit of Hannah Arendt,106768,82143,24625,movies-2016.csv,2016,0.7693597332534092,0.23064026674659074
4687,Dekalog 2016 Re-release,106494,106494,0,movies-2016.csv,2016,1.0,0.0
4688,Wrong,106425,46021,60404,movies-2012.csv,2012,0.4324265914963589,0.567573408503641
4689,The Charmer,106379,26167,80212,movies-2018.csv,2018,0.24597899961458558,0.7540210003854144
4690,Six Dance Lessons in Six Weeks,106323,106323,0,movies-2014.csv,2014,1.0,0.0
4691,The Bachelors,106212,0,106212,movies-2017.csv,2017,0.0,1.0
4692,The Brink,106057,106057,0,movies-2019.csv,2019,1.0,0.0
4693,Big Star: Nothing Can Hurt Me,105998,105998,0,movies-2013.csv,2013,1.0,0.0
4694,Miss Juneteenth,105908,92349,13559,movies-2020.csv,2020,0.8719737885712128,0.12802621142878726
4695,The Roads Not Taken,105439,3518,101921,movies-2020.csv,2020,0.03336526332761122,0.9666347366723888
4696,Never Heard,105271,105271,0,movies-2018.csv,2018,1.0,0.0
4697,Cold Case Hammarskjöld,104965,104965,0,movies-2019.csv,2019,1.0,0.0
4698,Always and Forever,104871,0,104871,movies-2019.csv,2019,0.0,1.0
4699,A Ciambra,104808,41934,62874,movies-2017.csv,2017,0.4001030455690405,0.5998969544309595
4700,Dictator,104734,104734,0,movies-2016.csv,2016,1.0,0.0
4701,Results,104507,104507,0,movies-2015.csv,2015,1.0,0.0
4702,Demon,104038,104038,0,movies-2016.csv,2016,1.0,0.0
4703,The Investigator,103739,103739,0,movies-2013.csv,2013,1.0,0.0
4704,Stevie Nicks: In Your Dreams,103028,103028,0,movies-2013.csv,2013,1.0,0.0
4705,Puerto Ricans in Paris,102890,102890,0,movies-2016.csv,2016,1.0,0.0
4706,Brake,102819,4876,97943,movies-2012.csv,2012,0.047423141637246036,0.952576858362754
4707,The Gracefield Incident,102256,0,102256,movies-2017.csv,2017,0.0,1.0
4708,Tanna,102225,46654,55571,movies-2016.csv,2016,0.45638542430912205,0.543614575690878
4709,Andrei Rublev 2018 Re-release,102021,102021,0,movies-2018.csv,2018,1.0,0.0
4710,Becoming Traviata,102015,62652,39363,movies-2013.csv,2013,0.6141449786796059,0.38585502132039406
4711,Tower,101987,101987,0,movies-2016.csv,2016,1.0,0.0
4712,In the Family,101934,101934,0,movies-2011.csv,2011,1.0,0.0
4713,Hotel by the River,101879,28354,73525,movies-2019.csv,2019,0.2783105448620422,0.7216894551379578
4714,Kill Me Three Times,101807,24296,77511,movies-2015.csv,2015,0.23864763719587062,0.7613523628041294
4715,Magnus,101739,8944,92795,movies-2016.csv,2016,0.08791122381780832,0.9120887761821916
4716,Those Who Remained,101737,0,101737,movies-2019.csv,2019,0.0,1.0
4717,Rubber,101729,100370,1359,movies-2011.csv,2011,0.9866409774990416,0.01335902250095843
4718,Kickboxer: Retaliation,101690,4537,97153,movies-2018.csv,2018,0.044615989772839024,0.955384010227161
4719,A Lego Brickumentary,101531,101531,0,movies-2015.csv,2015,1.0,0.0
4720,Blazing Saddles 2013 Re-release,101481,101481,0,movies-2013.csv,2013,1.0,0.0
4721,Man from Reno,101438,101438,0,movies-2015.csv,2015,1.0,0.0
4722,James White,101368,101368,0,movies-2015.csv,2015,1.0,0.0
4723,QT8: The First Eight,101346,51896,49450,movies-2019.csv,2019,0.5120675705010558,0.4879324294989442
4724,Korengal,101310,101310,0,movies-2014.csv,2014,1.0,0.0
4725,Beyond Sight: The Derek Rabelo Story,101074,101074,0,movies-2014.csv,2014,1.0,0.0
4726,First Cow,101068,101068,0,movies-2020.csv,2020,1.0,0.0
4727,The Man Who Fell to Earth,100468,100072,396,movies-2011.csv,2011,0.996058446470518,0.003941553529482024
4728,The United States of Autism,100403,100403,0,movies-2013.csv,2013,1.0,0.0
4729,One Track Heart: The Story of Krishna Das,100401,100401,0,movies-2013.csv,2013,1.0,0.0
4730,All About Nina,100335,100335,0,movies-2018.csv,2018,1.0,0.0
4731,Rejoice and Shout,100237,100237,0,movies-2011.csv,2011,1.0,0.0
4732,Papi Chulo,99546,84703,14843,movies-2019.csv,2019,0.8508930544672815,0.14910694553271855
4733,Heavy Water,99503,55446,44057,movies-2019.csv,2019,0.5572294302684341,0.44277056973156587
4734,Meow Wolf: Origin Story,99488,99488,0,movies-2018.csv,2018,1.0,0.0
4735,Cemetery of Splendor,98932,51950,46982,movies-2015.csv,2015,0.5251081550964298,0.4748918449035701
4736,High Strung Free Dance 2019 Re-release,98481,83891,14590,movies-2019.csv,2019,0.8518495953534184,0.14815040464658158
4737,Aida's Secrets,98468,98468,0,movies-2017.csv,2017,1.0,0.0
4738,Reign of Judges: Title of Liberty - Concept Short,98408,93224,5184,movies-2018.csv,2018,0.9473213559873181,0.052678644012681894
4739,Blind,98280,12522,85758,movies-2017.csv,2017,0.1274114774114774,0.8725885225885226
4740,Charlie Says,98240,40685,57555,movies-2019.csv,2019,0.41413884364820847,0.5858611563517915
4741,National Theatre Live: Macbeth,97857,97857,0,movies-2018.csv,2018,1.0,0.0
4742,Tim Timmerman: Hope of America,97727,97727,0,movies-2017.csv,2017,1.0,0.0
4743,The Here After,97699,0,97699,movies-2015.csv,2015,0.0,1.0
4744,In Bloom,97236,56092,41144,movies-2013.csv,2013,0.5768645357686454,0.4231354642313546
4745,Difret,97205,49667,47538,movies-2015.csv,2015,0.5109510827632323,0.48904891723676763
4746,Prassthanam,97204,19984,77220,movies-2019.csv,2019,0.20558824739722645,0.7944117526027735
4747,A Field in England,97195,32846,64349,movies-2013.csv,2013,0.3379391944030043,0.6620608055969958
4748,Little Monsters,97111,0,97111,movies-2019.csv,2019,0.0,1.0
4749,A Little Help,96868,96868,0,movies-2011.csv,2011,1.0,0.0
4750,Leviathan,96778,76202,20576,movies-2013.csv,2013,0.7873896960052904,0.21261030399470954
4751,Singin' in the Rain 2013 Re-release,96763,96763,0,movies-2013.csv,2013,1.0,0.0
4752,Hardflip,96734,96734,0,movies-2012.csv,2012,1.0,0.0
4753,Sunshine Superman,96715,88097,8618,movies-2015.csv,2015,0.9108928294473453,0.08910717055265471
4754,Godspeed: The Race Across America,96690,96690,0,movies-2018.csv,2018,1.0,0.0
4755,A Poem Is a Naked Person,96592,96592,0,movies-2015.csv,2015,1.0,0.0
4756,Dina,96524,90503,6021,movies-2017.csv,2017,0.9376217313828685,0.06237826861713149
4757,Hiroshima Mon Amour 2014 Re-release,96439,96439,0,movies-2014.csv,2014,1.0,0.0
4758,My Reincarnation,96115,92822,3293,movies-2011.csv,2011,0.9657389585392498,0.034261041460750145
4759,A Bigger Splash 2019 Re-release,95826,95826,0,movies-2019.csv,2019,1.0,0.0
4760,Saand Ki Aankh,95724,0,95724,movies-2019.csv,2019,0.0,1.0
4761,Ardor,95549,18565,76984,movies-2014.csv,2014,0.19429821348208773,0.8057017865179122
4762,The Lovers & the Despot,95521,55511,40010,movies-2016.csv,2016,0.5811392259293768,0.4188607740706232
4763,The Final Wish,95215,25183,70032,movies-2019.csv,2019,0.26448563776715855,0.7355143622328415
4764,The Night Eats the World,95208,0,95208,movies-2018.csv,2018,0.0,1.0
4765,Queen of Earth,95183,91218,3965,movies-2015.csv,2015,0.958343401657859,0.04165659834214093
4766,Saala Khadoos,94787,76931,17856,movies-2016.csv,2016,0.8116197368837499,0.1883802631162501
4767,The Fight Within,94326,94326,0,movies-2016.csv,2016,1.0,0.0
4768,Keep Watching,94178,94178,0,movies-2017.csv,2017,1.0,0.0
4769,Blue Caprice,93995,93995,0,movies-2013.csv,2013,1.0,0.0
4770,Let the Corpses Tan,93409,93409,0,movies-2018.csv,2018,1.0,0.0
4771,First Lady,93298,93298,0,movies-2020.csv,2020,1.0,0.0
4772,Will You Still Love Me Tomorrow?,93046,6694,86352,movies-2013.csv,2013,0.07194290995851514,0.9280570900414848
4773,Vamps,92748,3361,89387,movies-2012.csv,2012,0.03623797817742701,0.963762021822573
4774,The First Time,92654,22836,69818,movies-2012.csv,2012,0.24646534418373733,0.7535346558162627
4775,American: The Bill Hicks Story,92234,92234,0,movies-2011.csv,2011,1.0,0.0
4776,Into the Forest,92166,9995,82171,movies-2016.csv,2016,0.10844563070980621,0.8915543692901938
4777,Nancy,92000,80115,11885,movies-2018.csv,2018,0.8708152173913043,0.12918478260869565
4778,Generation War,91595,91595,0,movies-2014.csv,2014,1.0,0.0
4779,Legends from the Sky,91462,91462,0,movies-2015.csv,2015,1.0,0.0
4780,Other People,91441,91441,0,movies-2016.csv,2016,1.0,0.0
4781,Evil Bong 3: The Wrath of Bong,91260,91260,0,movies-2011.csv,2011,1.0,0.0
4782,Morris from America,91151,91151,0,movies-2016.csv,2016,1.0,0.0
4783,A Kind of Murder,91149,2915,88234,movies-2016.csv,2016,0.03198060318818638,0.9680193968118136
4784,Mapplethorpe,91002,91002,0,movies-2019.csv,2019,1.0,0.0
4785,BANDSTAND: The Broadway Musical on Screen 2018 Re-release,91000,91000,0,movies-2018.csv,2018,1.0,0.0
4786,Because of Grácia,90878,90878,0,movies-2017.csv,2017,1.0,0.0
4787,Porto,90849,15126,75723,movies-2017.csv,2017,0.16649605389162236,0.8335039461083776
4788,Heroic Antics,90785,63649,27136,movies-2014.csv,2014,0.7010959960345872,0.2989040039654128
4789,Beasts of No Nation,90777,90777,0,movies-2015.csv,2015,1.0,0.0
4790,Yuri!!! On Ice,90751,81878,8873,movies-2018.csv,2018,0.902226972705535,0.09777302729446508
4791,Loopers: The Caddie's Long Walk,90679,90679,0,movies-2019.csv,2019,1.0,0.0
4792,Moonwalkers,90646,0,90646,movies-2016.csv,2016,0.0,1.0
4793,The Good Neighbor,90573,0,90573,movies-2016.csv,2016,0.0,1.0
4794,Fireworks Wednesday 2016 Re-release,90519,90519,0,movies-2016.csv,2016,1.0,0.0
4795,Minding the Gap,90328,11998,78330,movies-2018.csv,2018,0.1328270303781773,0.8671729696218227
4796,Dark Horse,90136,90136,0,movies-2015.csv,2015,1.0,0.0
4797,King's Faith,90106,90106,0,movies-2013.csv,2013,1.0,0.0
4798,Running for Grace,89988,89988,0,movies-2018.csv,2018,1.0,0.0
4799,Pump,89787,89787,0,movies-2014.csv,2014,1.0,0.0
4800,The Principle,89543,89543,0,movies-2014.csv,2014,1.0,0.0
4801,Max Winslow and the House of Secrets,89532,31250,58282,movies-2020.csv,2020,0.3490372157440915,0.6509627842559085
4802,Somebody Up There Likes Me,89435,89435,0,movies-2013.csv,2013,1.0,0.0
4803,Cat on a Hot Tin Roof,89332,89332,0,movies-2018.csv,2018,1.0,0.0
4804,Salvation Boulevard,89182,28468,60714,movies-2011.csv,2011,0.31921239712049515,0.6807876028795048
4805,Night of the Living Dead,89029,89029,0,movies-2017.csv,2017,1.0,0.0
4806,This Is Not a Film,88758,77016,11742,movies-2012.csv,2012,0.8677076995876428,0.1322923004123572
4807,The Lumber Baron,88336,88336,0,movies-2019.csv,2019,1.0,0.0
4808,Jewtopia,88327,46437,41890,movies-2013.csv,2013,0.5257395813284726,0.4742604186715274
4809,Money for Nothing: Inside the Federal Reserve,88045,88045,0,movies-2013.csv,2013,1.0,0.0
4810,Jim Allison: Breakthrough,87984,87984,0,movies-2019.csv,2019,1.0,0.0
4811,Hyena Road,87768,1430,86338,movies-2015.csv,2015,0.01629295415185489,0.9837070458481451
4812,Ocean Waves,87738,87738,0,movies-2016.csv,2016,1.0,0.0
4813,Glory,87728,18415,69313,movies-2017.csv,2017,0.2099101769104505,0.7900898230895496
4814,Exporting Raymond,87727,87727,0,movies-2011.csv,2011,1.0,0.0
4815,Author: The JT LeRoy Story,87686,85999,1687,movies-2016.csv,2016,0.9807608968364391,0.019239103163560888
4816,Goldstone 2018 Re-release,87639,87639,0,movies-2018.csv,2018,1.0,0.0
4817,Ammonite,87552,87552,0,movies-2020.csv,2020,1.0,0.0
4818,ECCO,86858,86858,0,movies-2019.csv,2019,1.0,0.0
4819,Singularity,86822,4176,82646,movies-2017.csv,2017,0.04809840823754348,0.9519015917624565
4820,Vault,86741,29491,57250,movies-2019.csv,2019,0.3399891631408446,0.6600108368591554
4821,Gueros,86736,60114,26622,movies-2015.csv,2015,0.6930686220254566,0.30693137797454345
4822,School Life,86616,37381,49235,movies-2017.csv,2017,0.4315715341276439,0.5684284658723562
4823,Beuys,86451,65410,21041,movies-2018.csv,2018,0.7566135730066743,0.2433864269933257
4824,"My Love, Don't Cross That River 2016 Re-release",86446,86446,0,movies-2016.csv,2016,1.0,0.0
4825,National Theater Live: Cyrano de Bergerac,86300,86300,0,movies-2019.csv,2019,1.0,0.0
4826,Crazy Wisdom: The Life & Times of Chogyam Trungpa Rinpoche,86202,86202,0,movies-2011.csv,2011,1.0,0.0
4827,Rapt 2011 Re-release,86028,45759,40269,movies-2011.csv,2011,0.5319082159296973,0.4680917840703027
4828,Mudbound,85955,0,85955,movies-2017.csv,2017,0.0,1.0
4829,Tab Hunter Confidential,85812,85812,0,movies-2015.csv,2015,1.0,0.0
4830,Jackals,85410,0,85410,movies-2017.csv,2017,0.0,1.0
4831,Skid Row Marathon,84997,84997,0,movies-2019.csv,2019,1.0,0.0
4832,Ran 2016 Re-release,84789,66097,18692,movies-2016.csv,2016,0.779546875184281,0.22045312481571902
4833,Wretches & Jabberers,84610,84610,0,movies-2011.csv,2011,1.0,0.0
4834,Visitors,84577,84577,0,movies-2014.csv,2014,1.0,0.0
4835,Woodstock,84440,84440,0,movies-2019.csv,2019,1.0,0.0
4836,Heaven Knows What,84417,80734,3683,movies-2015.csv,2015,0.9563713470035656,0.04362865299643437
4837,The Diabolical,84259,0,84259,movies-2015.csv,2015,0.0,1.0
4838,Chapter & Verse,84147,84147,0,movies-2017.csv,2017,1.0,0.0
4839,Los Sures,83992,83992,0,movies-2016.csv,2016,1.0,0.0
4840,The Disappearance of My Mother,83930,24951,58979,movies-2019.csv,2019,0.29728345049445964,0.7027165495055403
4841,"Nico, 1988",83558,73304,10254,movies-2018.csv,2018,0.8772828454486704,0.12271715455132962
4842,The Look,83137,19988,63149,movies-2011.csv,2011,0.2404224352574666,0.7595775647425335
4843,The Kindness of Strangers,83042,2705,80337,movies-2019.csv,2019,0.032573878278461504,0.9674261217215385
4844,Hateship Loveship,83008,54030,28978,movies-2014.csv,2014,0.6509011179645335,0.34909888203546646
4845,Alien Abduction,82725,12897,69828,movies-2014.csv,2014,0.15590208522212148,0.8440979147778785
4846,Doctor Who: The Woman Who Fell to Earth,82698,82698,0,movies-2018.csv,2018,1.0,0.0
4847,12 O'Clock Boys,82614,82614,0,movies-2014.csv,2014,1.0,0.0
4848,V/H/S Viral,82409,2756,79653,movies-2014.csv,2014,0.033442949192442575,0.9665570508075574
4849,The Treasure,82392,50203,32189,movies-2016.csv,2016,0.6093188659093116,0.39068113409068844
4850,Water & Power,82312,82312,0,movies-2014.csv,2014,1.0,0.0
4851,Prey,82258,0,82258,movies-2019.csv,2019,0.0,1.0
4852,Careful What You Wish For,82230,0,82230,movies-2015.csv,2015,0.0,1.0
4853,On the Basis of Sex 2020 Re-release,82150,82150,0,movies-2020.csv,2020,1.0,0.0
4854,The Whale,81881,81881,0,movies-2011.csv,2011,1.0,0.0
4855,King Cobra,81757,81757,0,movies-2016.csv,2016,1.0,0.0
4856,Inkubus,81600,81600,0,movies-2011.csv,2011,1.0,0.0
4857,Hating Breitbart,81432,81432,0,movies-2012.csv,2012,1.0,0.0
4858,The Girl in the Book,81379,8245,73134,movies-2015.csv,2015,0.10131606434092333,0.8986839356590767
4859,Yomeddine,81030,11308,69722,movies-2018.csv,2018,0.139553251882019,0.8604467481179809
4860,The Island President,80996,76398,4598,movies-2012.csv,2012,0.9432317645315818,0.05676823546841819
4861,Burning Bush,80943,16731,64212,movies-2013.csv,2013,0.2067010118231348,0.7932989881768652
4862,Woman Walks Ahead,80912,57528,23384,movies-2018.csv,2018,0.7109946608661262,0.28900533913387383
4863,Taur Mittran Di,80879,69510,11369,movies-2012.csv,2012,0.8594319909988996,0.14056800900110042
4864,Kind Hearts and Coronets 2019 Re-release,80795,35948,44847,movies-2019.csv,2019,0.444928522804629,0.555071477195371
4865,Nasty Baby,80772,79800,972,movies-2015.csv,2015,0.98796612687565,0.012033873124350022
4866,Trace Amounts,80735,80735,0,movies-2015.csv,2015,1.0,0.0
4867,Batman Returns 2019 Re-release,80699,70642,10057,movies-2019.csv,2019,0.8753763987162171,0.12462360128378294
4868,Ms. Purple,80657,80657,0,movies-2019.csv,2019,1.0,0.0
4869,Winnie Mandela,80634,80634,0,movies-2013.csv,2013,1.0,0.0
4870,Armstrong,80169,19740,60429,movies-2019.csv,2019,0.24622983946413202,0.753770160535868
4871,For the Love of Spock,80141,80141,0,movies-2016.csv,2016,1.0,0.0
4872,Ramaiya Vastavaiya,80108,80108,0,movies-2013.csv,2013,1.0,0.0
4873,En el séptimo día,79887,79887,0,movies-2018.csv,2018,1.0,0.0
4874,Aurangzeb,79665,0,79665,movies-2013.csv,2013,0.0,1.0
4875,Harvest of Empire,79627,79627,0,movies-2012.csv,2012,1.0,0.0
4876,Camp X-Ray,79624,13302,66322,movies-2014.csv,2014,0.16706018285943935,0.8329398171405606
4877,End of the Century,79607,66309,13298,movies-2019.csv,2019,0.832954388433178,0.16704561156682202
4878,Jayne Mansfield's Car,79178,14836,64342,movies-2013.csv,2013,0.18737528101240244,0.8126247189875976
4879,Concussion,78957,42606,36351,movies-2013.csv,2013,0.5396101675595577,0.4603898324404423
4880,Fort McCoy,78948,78948,0,movies-2014.csv,2014,1.0,0.0
4881,Christ Stopped at Eboli,78736,78736,0,movies-2019.csv,2019,1.0,0.0
4882,The Boxcar Children - Surprise Island,78676,78676,0,movies-2018.csv,2018,1.0,0.0
4883,Blackbird,78400,78400,0,movies-2015.csv,2015,1.0,0.0
4884,Harold and Lillian: A Hollywood Love Story,78301,78301,0,movies-2017.csv,2017,1.0,0.0
4885,Colliding Dreams,78288,78288,0,movies-2016.csv,2016,1.0,0.0
4886,Anesthesia,78270,32163,46107,movies-2016.csv,2016,0.41092372556535073,0.5890762744346493
4887,Nomad: In the Footsteps of Bruce Chatwin,78100,0,78100,movies-2020.csv,2020,0.0,1.0
4888,Un traductor,78075,13509,64566,movies-2018.csv,2018,0.17302593659942364,0.8269740634005763
4889,Jodi Breakers,78024,52618,25406,movies-2012.csv,2012,0.6743822413616323,0.32561775863836767
4890,Table No. 21,77621,46720,30901,movies-2013.csv,2013,0.6018989706393888,0.39810102936061115
4891,Chevalier,77590,25696,51894,movies-2015.csv,2015,0.3311766980280964,0.6688233019719036
4892,Circo,77466,77466,0,movies-2011.csv,2011,1.0,0.0
4893,The Art of the Steal,77450,64065,13385,movies-2014.csv,2014,0.8271788250484183,0.17282117495158167
4894,To Catch a Dollar: Muhammad Yunus Banks on America,77142,77142,0,movies-2011.csv,2011,1.0,0.0
4895,Parchi,77110,69431,7679,movies-2018.csv,2018,0.9004149915704838,0.09958500842951627
4896,The Missing Picture,76933,52164,24769,movies-2014.csv,2014,0.6780445322553391,0.32195546774466094
4897,Fast Color,76916,76916,0,movies-2019.csv,2019,1.0,0.0
4898,Mademoiselle C,76621,48668,27953,movies-2013.csv,2013,0.6351783453622375,0.3648216546377625
4899,The New Rijksmuseum - The Film,76460,40578,35882,movies-2015.csv,2015,0.5307088673816375,0.4692911326183625
4900,Don't Blink,76134,76134,0,movies-2016.csv,2016,1.0,0.0
4901,93Queen,76056,76056,0,movies-2018.csv,2018,1.0,0.0
4902,Greener Grass,76045,51456,24589,movies-2019.csv,2019,0.6766519823788546,0.3233480176211454
4903,Whitey: United States of America v. James J. Bulger,75881,75881,0,movies-2014.csv,2014,1.0,0.0
4904,Wish You Were Here 2013 Re-release,75870,46347,29523,movies-2013.csv,2013,0.6108738631870304,0.38912613681296954
4905,Into the White 2013 Re-release,75747,704,75043,movies-2013.csv,2013,0.009294097456004858,0.9907059025439952
4906,Touch Me Not,75507,13782,61725,movies-2018.csv,2018,0.18252612340577695,0.8174738765942231
4907,The Riot Act,75506,75506,0,movies-2018.csv,2018,1.0,0.0
4908,Swim Little Fish Swim,75504,3877,71627,movies-2014.csv,2014,0.05134827293918203,0.948651727060818
4909,Bill Nye: Science Guy,74909,74909,0,movies-2017.csv,2017,1.0,0.0
4910,Where Is Kyra?,74821,59717,15104,movies-2018.csv,2018,0.7981315406102565,0.20186845938974352
4911,The Ornithologist,74714,50511,24203,movies-2016.csv,2016,0.6760580346387558,0.3239419653612442
4912,Above and Beyond: NASA's Journey to Tomorrow,74711,74711,0,movies-2018.csv,2018,1.0,0.0
4913,Batkid Begins: The Wish Heard Around the World,74709,74709,0,movies-2015.csv,2015,1.0,0.0
4914,The Monster,74700,12544,62156,movies-2016.csv,2016,0.16792503346720214,0.8320749665327979
4915,We Come as Friends,74633,50921,23712,movies-2014.csv,2014,0.6822853161470127,0.3177146838529873
4916,Stations of the Cross,74509,1505,73004,movies-2014.csv,2014,0.02019890214604947,0.9798010978539505
4917,Made in Bangladesh,74432,5322,69110,movies-2019.csv,2019,0.07150150472914875,0.9284984952708513
4918,Reset,74341,5454,68887,movies-2016.csv,2016,0.07336463055379938,0.9266353694462006
4919,The Boy Downstairs,73988,13638,60350,movies-2018.csv,2018,0.1843271881926799,0.8156728118073201
4920,The Keeping Room,73922,27166,46756,movies-2015.csv,2015,0.3674954681962068,0.6325045318037932
4921,After Auschwitz,73885,73885,0,movies-2018.csv,2018,1.0,0.0
4922,War Pigs,73701,0,73701,movies-2015.csv,2015,0.0,1.0
4923,Wait for Your Laugh,73585,73585,0,movies-2017.csv,2017,1.0,0.0
4924,On the Ice,73492,73492,0,movies-2012.csv,2012,1.0,0.0
4925,Primal Rage: The Legend of Konga,73383,21497,51886,movies-2018.csv,2018,0.2929425071201777,0.7070574928798223
4926,Vengeance: A Love Story,73270,4526,68744,movies-2017.csv,2017,0.06177152995769073,0.9382284700423092
4927,Te Ata,73236,73236,0,movies-2017.csv,2017,1.0,0.0
4928,Antonio Lopez 1970: Sex Fashion & Disco,73122,43169,29953,movies-2018.csv,2018,0.5903695194332759,0.40963048056672413
4929,Buster's Mal Heart,73121,73121,0,movies-2017.csv,2017,1.0,0.0
4930,Headshot,73010,0,73010,movies-2017.csv,2017,0.0,1.0
4931,5B,72968,72968,0,movies-2019.csv,2019,1.0,0.0
4932,Do Not Resist,72791,72791,0,movies-2016.csv,2016,1.0,0.0
4933,The Green Wave,72152,0,72152,movies-2011.csv,2011,0.0,1.0
4934,Partisan,72151,0,72151,movies-2015.csv,2015,0.0,1.0
4935,After Tiller,72125,72125,0,movies-2013.csv,2013,1.0,0.0
4936,Veil of Tears,72078,72078,0,movies-2014.csv,2014,1.0,0.0
4937,The Invisible War,71968,71968,0,movies-2012.csv,2012,1.0,0.0
4938,The Chambermaid Lynn,71918,315,71603,movies-2015.csv,2015,0.004379988320031147,0.9956200116799688
4939,Raiders!: The Story of the Greatest Fan Film Ever Made,71916,71916,0,movies-2016.csv,2016,1.0,0.0
4940,Come and See 2020 Re-release,71909,71909,0,movies-2020.csv,2020,1.0,0.0
4941,An Oversimplification of Her Beauty,71906,71906,0,movies-2013.csv,2013,1.0,0.0
4942,As I Lay Dying,71759,16697,55062,movies-2013.csv,2013,0.23268161484970526,0.7673183851502947
4943,Runaway Slave,71737,71737,0,movies-2012.csv,2012,1.0,0.0
4944,Flamenco Flamenco 2014 Re-release,71732,71732,0,movies-2014.csv,2014,1.0,0.0
4945,"Je t'aime, je t'aime 2014 Re-release",71717,71717,0,movies-2014.csv,2014,1.0,0.0
4946,Eisenstein in Guanajuato 2015 Re-release,71570,34282,37288,movies-2016.csv,2016,0.4789995808299567,0.5210004191700434
4947,The Congressman,71451,71451,0,movies-2016.csv,2016,1.0,0.0
4948,My Journey Through French Cinema,71174,52214,18960,movies-2016.csv,2016,0.7336105881361171,0.2663894118638829
4949,Free Trip to Egypt 2019 Re-release,71087,71087,0,movies-2019.csv,2019,1.0,0.0
4950,Freaks of Nature,70958,70958,0,movies-2015.csv,2015,1.0,0.0
4951,Norman Lear: Just Another Version of You,70950,70950,0,movies-2016.csv,2016,1.0,0.0
4952,The Better Angels,70918,70918,0,movies-2014.csv,2014,1.0,0.0
4953,4:44 Last Day on Earth,70851,17801,53050,movies-2012.csv,2012,0.2512455716927072,0.7487544283072928
4954,Miss Lovely,70845,0,70845,movies-2014.csv,2014,0.0,1.0
4955,How to Build a Girl,70632,70632,0,movies-2020.csv,2020,1.0,0.0
4956,Seasons of Gray,70605,70605,0,movies-2013.csv,2013,1.0,0.0
4957,Fireflies in the Garden 2011 Re-release,70600,70600,0,movies-2011.csv,2011,1.0,0.0
4958,Go for Sisters,70495,70495,0,movies-2013.csv,2013,1.0,0.0
4959,The Fog 2018 Re-release,70421,70421,0,movies-2018.csv,2018,1.0,0.0
4960,Wastelander,70045,70045,0,movies-2018.csv,2018,1.0,0.0
4961,Nick Mason's Saucerful of Secrets: Live at the Roundhouse,69967,32444,37523,movies-2020.csv,2020,0.4637043177497963,0.5362956822502036
4962,Turn It Around: The Story of East Bay Punk,69787,69787,0,movies-2017.csv,2017,1.0,0.0
4963,Chef Flynn,69542,68407,1135,movies-2018.csv,2018,0.9836789278421674,0.016321072157832676
4964,Back to the Jurassic,69423,4351,65072,movies-2015.csv,2015,0.0626737536551287,0.9373262463448713
4965,An Inconsistent Truth,69394,69394,0,movies-2012.csv,2012,1.0,0.0
4966,Siddharth,69310,60537,8773,movies-2014.csv,2014,0.8734237483768575,0.1265762516231424
4967,Rocky Handsome,69289,0,69289,movies-2016.csv,2016,0.0,1.0
4968,Bajatey Raho,69085,55397,13688,movies-2013.csv,2013,0.8018672649634508,0.19813273503654918
4969,The White Sheik 2019 re-release,68940,50850,18090,movies-2019.csv,2019,0.737597911227154,0.26240208877284593
4970,My Entire High School Sinking Into the Sea,68883,68883,0,movies-2017.csv,2017,1.0,0.0
4971,Klown 2012 Re-release,68795,68795,0,movies-2012.csv,2012,1.0,0.0
4972,Noma: My Perfect Storm,68622,21130,47492,movies-2015.csv,2015,0.30791874326017893,0.692081256739821
4973,Take Me to the River,68598,68598,0,movies-2014.csv,2014,1.0,0.0
4974,Mastizaade,68583,43403,25180,movies-2016.csv,2016,0.6328536226178499,0.3671463773821501
4975,Wildflower,68577,18062,50515,movies-2016.csv,2016,0.2633827668168628,0.7366172331831372
4976,Outside In,68492,68492,0,movies-2018.csv,2018,1.0,0.0
4977,Alive and Kicking,68485,68485,0,movies-2017.csv,2017,1.0,0.0
4978,Last Year at Marienbad 2019 Re-release,68402,63425,4977,movies-2019.csv,2019,0.9272389696207713,0.07276103037922868
4979,The Eyes of Orson Welles,68328,10253,58075,movies-2018.csv,2018,0.15005561409670998,0.84994438590329
4980,10x10,68260,2263,65997,movies-2018.csv,2018,0.033152651626135364,0.9668473483738647
4981,Maidentrip,68243,68243,0,movies-2013.csv,2013,1.0,0.0
4982,¡He matado a mi marido!,68017,45777,22240,movies-2019.csv,2019,0.6730229207404032,0.32697707925959685
4983,I Am Big Bird: The Caroll Spinney Story,67845,67845,0,movies-2015.csv,2015,1.0,0.0
4984,The Messenger,67816,67816,0,movies-2015.csv,2015,1.0,0.0
4985,Pray: The Story of Patrick Peyton,67814,67814,0,movies-2020.csv,2020,1.0,0.0
4986,Summer in the Forest,67743,45542,22201,movies-2017.csv,2017,0.6722761023279158,0.3277238976720842
4987,Sanam Teri Kasam,67736,22121,45615,movies-2016.csv,2016,0.32657670957836304,0.673423290421637
4988,The Greasy Strangler,67427,45878,21549,movies-2016.csv,2016,0.6804099248075697,0.3195900751924303
4989,For No Good Reason,67421,67421,0,movies-2014.csv,2014,1.0,0.0
4990,Making the Five Heartbeats,67415,67415,0,movies-2018.csv,2018,1.0,0.0
4991,Being Frank,67343,67343,0,movies-2019.csv,2019,1.0,0.0
4992,The Doctor from India,67136,67136,0,movies-2018.csv,2018,1.0,0.0
4993,Turbo Kid,67069,67069,0,movies-2015.csv,2015,1.0,0.0
4994,Side by Side,67054,58825,8229,movies-2012.csv,2012,0.8772780147343932,0.12272198526560682
4995,"3100, Run and Become",66789,65524,1265,movies-2018.csv,2018,0.9810597553489347,0.018940244651065294
4996,Pandora's Promise,66680,66680,0,movies-2013.csv,2013,1.0,0.0
4997,Max Rose,66680,66680,0,movies-2016.csv,2016,1.0,0.0
4998,King Georges,66175,66175,0,movies-2016.csv,2016,1.0,0.0
4999,Out in the Dark,66017,26966,39051,movies-2013.csv,2013,0.4084705454655619,0.5915294545344381
5000,All My Life,65852,0,65852,movies-2020.csv,2020,0.0,1.0
5001,D-Day,65536,0,65536,movies-2013.csv,2013,0.0,1.0
5002,Architects of Denial,65424,65424,0,movies-2017.csv,2017,1.0,0.0
5003,Sing Your Song,65310,47718,17592,movies-2012.csv,2012,0.730638493339458,0.26936150666054204
5004,You've Been Trumped,65220,29273,35947,movies-2012.csv,2012,0.44883471327813557,0.5511652867218645
5005,Through a Lens Darkly: Black Photographers and the Emergence of a People,65169,65169,0,movies-2014.csv,2014,1.0,0.0
5006,The Lesson,65142,9045,56097,movies-2015.csv,2015,0.13885051119093672,0.8611494888090633
5007,Toys in the Attic 2012 Re-release,64918,64918,0,movies-2012.csv,2012,1.0,0.0
5008,Manolo: the Boy Who Made Shoes for Lizards,64889,60056,4833,movies-2017.csv,2017,0.9255189631524604,0.07448103684753965
5009,Searching for Ingmar Bergman,64742,36686,28056,movies-2018.csv,2018,0.5666491612863366,0.4333508387136635
5010,The Jesus Rolls,64648,18169,46479,movies-2019.csv,2019,0.2810450439302067,0.7189549560697933
5011,"Monrovia, Indiana",64596,63944,652,movies-2018.csv,2018,0.9899064957582513,0.010093504241748714
5012,Battle of the Brides,64572,64572,0,movies-2011.csv,2011,1.0,0.0
5013,Let the Fire Burn,64489,64489,0,movies-2013.csv,2013,1.0,0.0
5014,Paulette 2015 Re-release,64125,29494,34631,movies-2015.csv,2015,0.4599454191033138,0.5400545808966861
5015,Girl Asleep,64056,60289,3767,movies-2016.csv,2016,0.9411920819283127,0.058807918071687275
5016,Making Waves: The Art of Cinematic Sound,63998,53144,10854,movies-2019.csv,2019,0.8304009500296884,0.16959904997031158
5017,Jealousy,63946,63946,0,movies-2014.csv,2014,1.0,0.0
5018,The Details,63595,63595,0,movies-2012.csv,2012,1.0,0.0
5019,A Liar's Autobiography: The Untrue Story of Monty Python's Graham Chapman,63469,5102,58367,movies-2012.csv,2012,0.08038570010556334,0.9196142998944367
5020,I Smile Back,63373,58738,4635,movies-2015.csv,2015,0.9268615972101684,0.07313840278983164
5021,Trapped,63241,63241,0,movies-2016.csv,2016,1.0,0.0
5022,The Last of the Unjust,63136,40563,22573,movies-2013.csv,2013,0.6424702230106437,0.3575297769893563
5023,No Tears for the Dead,63063,63063,0,movies-2014.csv,2014,1.0,0.0
5024,Creative Control,63014,63014,0,movies-2016.csv,2016,1.0,0.0
5025,"Love, Antosha",62900,50168,12732,movies-2019.csv,2019,0.7975834658187599,0.20241653418124006
5026,The Gardener,62734,62734,0,movies-2018.csv,2018,1.0,0.0
5027,The Swan,62716,2367,60349,movies-2018.csv,2018,0.0377415651508387,0.9622584348491613
5028,Drunk Stoned Brilliant Dead,62660,62660,0,movies-2015.csv,2015,1.0,0.0
5029,The Tiger Hunter,62398,62398,0,movies-2017.csv,2017,1.0,0.0
5030,Mifune: The Last Samurai,62279,62279,0,movies-2016.csv,2016,1.0,0.0
5031,Public Speaking,62173,62173,0,movies-2011.csv,2011,1.0,0.0
5032,Trigun: Badlands Rumble 2011 Re-release,62027,62027,0,movies-2011.csv,2011,1.0,0.0
5033,"I, Me aur Main",61863,0,61863,movies-2013.csv,2013,0.0,1.0
5034,Dark Star: HR Gigers Welt,61845,61845,0,movies-2015.csv,2015,1.0,0.0
5035,In a Valley of Violence,61797,61797,0,movies-2016.csv,2016,1.0,0.0
5036,If a Tree Falls: A Story of the Earth Liberation Front,61794,61794,0,movies-2011.csv,2011,1.0,0.0
5037,River Runs Red,61789,9893,51896,movies-2018.csv,2018,0.1601094045865769,0.8398905954134231
5038,Amour Fou,61693,13702,47991,movies-2014.csv,2014,0.22209975199779552,0.7779002480022045
5039,Quill: The Life of a Guide Dog 2012 Re-release,61674,15674,46000,movies-2012.csv,2012,0.2541427505918215,0.7458572494081784
5040,Backwards,61465,61465,0,movies-2012.csv,2012,1.0,0.0
5041,Donald Cried,61406,61406,0,movies-2017.csv,2017,1.0,0.0
5042,Never Goin' Back,61271,61271,0,movies-2018.csv,2018,1.0,0.0
5043,Here and Now,61271,13892,47379,movies-2018.csv,2018,0.22673042711886537,0.7732695728811346
5044,The Seasons In Quincy: Four Portraits of John Berger,61267,28456,32811,movies-2016.csv,2016,0.46445884407592997,0.53554115592407
5045,The Outcasts,61250,1455,59795,movies-2017.csv,2017,0.023755102040816326,0.9762448979591837
5046,The Untamed,61249,27593,33656,movies-2017.csv,2017,0.45050531437247954,0.5494946856275205
5047,The Mountain,61035,61035,0,movies-2019.csv,2019,1.0,0.0
5048,The Bodyguard 2012 Re-release,61020,61020,0,movies-2012.csv,2012,1.0,0.0
5049,The Sacrifice 2017 Re-release,61018,61018,0,movies-2017.csv,2017,1.0,0.0
5050,Independent Lens: Don't Stop Believin': Everyman's Journey,61018,61018,0,movies-2013.csv,2013,1.0,0.0
5051,Love U... Mr. Kalakaar!,60956,48557,12399,movies-2011.csv,2011,0.7965909836603452,0.20340901633965483
5052,The Wicker Man 2013 Re-release,60891,60891,0,movies-2013.csv,2013,1.0,0.0
5053,It's a Disaster,60818,60818,0,movies-2013.csv,2013,1.0,0.0
5054,A Kid Like Jake,60784,58403,2381,movies-2018.csv,2018,0.9608285075019742,0.039171492498025796
5055,Apprentice,60752,2578,58174,movies-2016.csv,2016,0.042434816960758494,0.9575651830392415
5056,How to Live Forever,60630,60630,0,movies-2011.csv,2011,1.0,0.0
5057,Viper Club,60607,60607,0,movies-2018.csv,2018,1.0,0.0
5058,Too Late,60438,60438,0,movies-2016.csv,2016,1.0,0.0
5059,Limelight,60335,60335,0,movies-2011.csv,2011,1.0,0.0
5060,Crime After Crime,60291,60291,0,movies-2011.csv,2011,1.0,0.0
5061,Wetlands 2014 Re-release,60230,59478,752,movies-2014.csv,2014,0.9875145276440312,0.012485472355968787
5062,Presenting Princess Shaw,60197,60197,0,movies-2016.csv,2016,1.0,0.0
5063,Just One Drop,60078,60078,0,movies-2017.csv,2017,1.0,0.0
5064,Gregory Crewdson: Brief Encounters,60064,60064,0,movies-2012.csv,2012,1.0,0.0
5065,Decoding Annie Parker,60048,48390,11658,movies-2014.csv,2014,0.8058553157474021,0.19414468425259793
5066,The Force,59912,59912,0,movies-2017.csv,2017,1.0,0.0
5067,John Fogerty: 50 Year Trip - Live at Red Rocks,59795,59795,0,movies-2019.csv,2019,1.0,0.0
5068,Frontera,59696,59696,0,movies-2014.csv,2014,1.0,0.0
5069,The Extraordinary Voyage,59424,52986,6438,movies-2012.csv,2012,0.8916599353796446,0.1083400646203554
5070,Cheap Thrills,59424,59424,0,movies-2014.csv,2014,1.0,0.0
5071,Sweet Dreams,59403,59403,0,movies-2013.csv,2013,1.0,0.0
5072,My Brothers' Crossing,59395,59395,0,movies-2020.csv,2020,1.0,0.0
5073,Bomb City,59329,59329,0,movies-2018.csv,2018,1.0,0.0
5074,Bang! The Bert Berns Story,59299,59299,0,movies-2017.csv,2017,1.0,0.0
5075,Saint Frances,59257,44330,14927,movies-2020.csv,2020,0.7480972712084648,0.2519027287915352
5076,Digimon Adventure tri. Part 4: Loss,59114,59114,0,movies-2018.csv,2018,1.0,0.0
5077,The Trials of Muhammad Ali,59081,59081,0,movies-2013.csv,2013,1.0,0.0
5078,The One I Wrote for You,58872,58872,0,movies-2014.csv,2014,1.0,0.0
5079,Sagrada: The Mystery of Creation 2014 Re-release,58755,58755,0,movies-2014.csv,2014,1.0,0.0
5080,The Conformist 2014 Re-release,58657,58657,0,movies-2014.csv,2014,1.0,0.0
5081,Horn from the Heart: The Paul Butterfield Story,58597,58597,0,movies-2018.csv,2018,1.0,0.0
5082,Putty Hill,58585,49918,8667,movies-2011.csv,2011,0.852061107792097,0.14793889220790304
5083,Cynthia,58177,58177,0,movies-2018.csv,2018,1.0,0.0
5084,Faust,58132,58132,0,movies-2013.csv,2013,1.0,0.0
5085,In Search of Greatness,58090,58090,0,movies-2018.csv,2018,1.0,0.0
5086,The Boom,57962,57962,0,movies-2017.csv,2017,1.0,0.0
5087,Rififi 2015 Re-release,57749,57749,0,movies-2015.csv,2015,1.0,0.0
5088,Command and Control,57635,57635,0,movies-2016.csv,2016,1.0,0.0
5089,Battleship Potemkin,57620,51198,6422,movies-2011.csv,2011,0.888545643873655,0.11145435612634502
5090,Playback,57587,264,57323,movies-2012.csv,2012,0.00458436799972216,0.9954156320002778
5091,Sold,57527,57527,0,movies-2016.csv,2016,1.0,0.0
5092,Court,57416,22898,34518,movies-2015.csv,2015,0.39880869444057404,0.6011913055594259
5093,Ramen Heads,57345,57345,0,movies-2018.csv,2018,1.0,0.0
5094,Run & Jump,57189,20061,37128,movies-2014.csv,2014,0.3507842417248072,0.6492157582751927
5095,Mickey and the Bear,57188,57188,0,movies-2019.csv,2019,1.0,0.0
5096,My Joy,56857,6298,50559,movies-2011.csv,2011,0.11076912253548375,0.8892308774645162
5097,The Battle of Algiers 2016 Re-release,56853,56853,0,movies-2016.csv,2016,1.0,0.0
5098,Farmageddon,56573,56573,0,movies-2011.csv,2011,1.0,0.0
5099,Muran,56493,30116,26377,movies-2011.csv,2011,0.5330925955428106,0.46690740445718937
5100,Beyond the Black Rainbow,56491,56491,0,movies-2012.csv,2012,1.0,0.0
5101,Big Men,56286,56286,0,movies-2014.csv,2014,1.0,0.0
5102,Saving Brinton,56218,56218,0,movies-2017.csv,2017,1.0,0.0
5103,Wedding Doll,56196,56196,0,movies-2016.csv,2016,1.0,0.0
5104,Notebook,56166,0,56166,movies-2019.csv,2019,0.0,1.0
5105,False Confessions,56165,29245,26920,movies-2017.csv,2017,0.5206979435591561,0.47930205644084395
5106,Évolution,55985,24770,31215,movies-2016.csv,2016,0.4424399392694472,0.5575600607305529
5107,Vitalina Varela,55862,14941,40921,movies-2019.csv,2019,0.2674626758798468,0.7325373241201533
5108,Terms and Conditions May Apply,55824,55824,0,movies-2013.csv,2013,1.0,0.0
5109,Hellion,55708,55708,0,movies-2014.csv,2014,1.0,0.0
5110,XX,55668,30911,24757,movies-2017.csv,2017,0.5552741251706546,0.4447258748293454
5111,Recorder: The Marion Stokes Project,55632,55632,0,movies-2019.csv,2019,1.0,0.0
5112,Holidays,55621,0,55621,movies-2016.csv,2016,0.0,1.0
5113,Finding Joe,55518,55518,0,movies-2011.csv,2011,1.0,0.0
5114,Entertainment,55506,55506,0,movies-2015.csv,2015,1.0,0.0
5115,Naam Shabana,55429,0,55429,movies-2017.csv,2017,0.0,1.0
5116,Into Eternity,55366,55366,0,movies-2011.csv,2011,1.0,0.0
5117,C.O.G.,55301,55301,0,movies-2013.csv,2013,1.0,0.0
5118,Natural Selection,55282,55282,0,movies-2012.csv,2012,1.0,0.0
5119,Mamma Mia! 2018 Re-release,55168,39601,15567,movies-2018.csv,2018,0.7178255510440835,0.2821744489559165
5120,American Dream: Detroit,55092,55092,0,movies-2018.csv,2018,1.0,0.0
5121,The Lovely Month of May,55038,55038,0,movies-2013.csv,2013,1.0,0.0
5122,Zombeavers,54985,14947,40038,movies-2014.csv,2014,0.27183777393834685,0.7281622260616532
5123,DAZN Boxing: Canelo Alvarez vs. Rocky Fielding,54916,54916,0,movies-2018.csv,2018,1.0,0.0
5124,Snowmen,54805,54805,0,movies-2011.csv,2011,1.0,0.0
5125,What Our Fathers Did: A Nazi Legacy,54603,40119,14484,movies-2015.csv,2015,0.734739849458821,0.2652601505411791
5126,A Simple Wedding,54415,54415,0,movies-2020.csv,2020,1.0,0.0
5127,Digimon Adventure tri. Part 6: Future,54324,54324,0,movies-2018.csv,2018,1.0,0.0
5128,The Search for General Tso,54275,54275,0,movies-2015.csv,2015,1.0,0.0
5129,Wagner & Me 2012 Re-release,54215,37745,16470,movies-2012.csv,2012,0.6962095361062437,0.30379046389375636
5130,Line of Duty,54204,54204,0,movies-2013.csv,2013,1.0,0.0
5131,Last Passenger,54110,14806,39304,movies-2014.csv,2014,0.2736277952319349,0.7263722047680651
5132,Low Down,54051,54051,0,movies-2014.csv,2014,1.0,0.0
5133,A Beautiful Soul,54008,54008,0,movies-2012.csv,2012,1.0,0.0
5134,Surviving Progress,53953,53953,0,movies-2012.csv,2012,1.0,0.0
5135,The Assassin's Code,53940,11218,42722,movies-2018.csv,2018,0.20797182054134222,0.7920281794586578
5136,The Last Man on the Moon,53881,52482,1399,movies-2016.csv,2016,0.9740353742506634,0.0259646257493365
5137,The Summer of Sangaile,53843,4480,49363,movies-2015.csv,2015,0.0832048734283008,0.9167951265716991
5138,At Middleton,53837,53837,0,movies-2014.csv,2014,1.0,0.0
5139,Rising from Ashes,53804,38602,15202,movies-2013.csv,2013,0.7174559512303917,0.2825440487696082
5140,The Heir Apparent: Largo Winch 2011 Re-release,53793,10352,43441,movies-2011.csv,2011,0.1924413957206328,0.8075586042793672
5141,Down by Love,53780,675,53105,movies-2016.csv,2016,0.012551134250650799,0.9874488657493492
5142,The Legend of Hallowaiian,53738,451,53287,movies-2018.csv,2018,0.00839257136476981,0.9916074286352302
5143,The Other F Word,53714,53714,0,movies-2011.csv,2011,1.0,0.0
5144,Leonie 2013 Re-release,53692,53692,0,movies-2013.csv,2013,1.0,0.0
5145,Grass,53503,8084,45419,movies-2018.csv,2018,0.15109433115900042,0.8489056688409996
5146,The Great Silence,53074,53074,0,movies-2018.csv,2018,1.0,0.0
5147,Love Thy Nature,52947,41149,11798,movies-2015.csv,2015,0.7771733998149093,0.22282660018509076
5148,Ping Pong Summer,52909,52909,0,movies-2014.csv,2014,1.0,0.0
5149,To Be Takei,52823,52823,0,movies-2014.csv,2014,1.0,0.0
5150,Occupy Unmasked,52768,52768,0,movies-2012.csv,2012,1.0,0.0
5151,!Women Art Revolution,52681,52681,0,movies-2011.csv,2011,1.0,0.0
5152,Salvation Army,52511,3929,48582,movies-2014.csv,2014,0.07482241816000457,0.9251775818399954
5153,Going Attractions: The Definitive Story of the American Drive-in Movie,52458,52458,0,movies-2013.csv,2013,1.0,0.0
5154,A Tale of Winter,52431,23268,29163,movies-2014.csv,2014,0.4437832579962236,0.5562167420037764
5155,Birdboy: The Forgotten Children,52366,38786,13580,movies-2017.csv,2017,0.7406714280258183,0.25932857197418174
5156,American Dharma,51891,51891,0,movies-2019.csv,2019,1.0,0.0
5157,Quay,51858,51858,0,movies-2015.csv,2015,1.0,0.0
5158,The Snowman Trek,51743,51743,0,movies-2018.csv,2018,1.0,0.0
5159,Wanda 2018 Re-release,51713,51713,0,movies-2018.csv,2018,1.0,0.0
5160,Midnight Family,51712,42310,9402,movies-2019.csv,2019,0.8181853341584159,0.18181466584158415
5161,Tickling Giants,51499,51499,0,movies-2017.csv,2017,1.0,0.0
5162,The Yes Men Are Revolting,51331,50190,1141,movies-2015.csv,2015,0.9777717168962226,0.022228283103777443
5163,Venus and Serena,51271,51271,0,movies-2013.csv,2013,1.0,0.0
5164,God Loves Uganda,51229,51229,0,movies-2013.csv,2013,1.0,0.0
5165,Miss Fisher & the Crypt of Tears Special Screenings,51158,51032,126,movies-2020.csv,2020,0.9975370421048516,0.002462957895148364
5166,An Invisible Sign,51138,1279,49859,movies-2011.csv,2011,0.02501075521138879,0.9749892447886112
5167,The Unknowns,51035,51035,0,movies-2016.csv,2016,1.0,0.0
5168,The Good Doctor,51017,5206,45811,movies-2012.csv,2012,0.10204441656702667,0.8979555834329733
5169,As I Open My Eyes,50721,30989,19732,movies-2016.csv,2016,0.6109698152638946,0.38903018473610534
5170,House of Cardin,50659,0,50659,movies-2020.csv,2020,0.0,1.0
5171,Keep Quiet,50451,50451,0,movies-2017.csv,2017,1.0,0.0
5172,Clinton Road,50400,50400,0,movies-2019.csv,2019,1.0,0.0
5173,Wake in Fright 2012 Re-release,50394,50394,0,movies-2012.csv,2012,1.0,0.0
5174,Midnight Traveler,50336,41265,9071,movies-2019.csv,2019,0.8197910044500953,0.18020899554990463
5175,The Fitzgerald Family Christmas,50292,50292,0,movies-2012.csv,2012,1.0,0.0
5176,The Royal Wedding: Prince Harry and Meghan Markle,50264,50264,0,movies-2018.csv,2018,1.0,0.0
5177,The Retrieval,50257,50257,0,movies-2014.csv,2014,1.0,0.0
5178,In Order of Disappearance 2016 Re-release,50251,50251,0,movies-2016.csv,2016,1.0,0.0
5179,Quest,50022,47807,2215,movies-2017.csv,2017,0.955719483427292,0.04428051657270801
5180,The Discoverers,50020,50020,0,movies-2014.csv,2014,1.0,0.0
5181,Bigger,49997,46382,3615,movies-2018.csv,2018,0.9276956617397044,0.07230433826029561
5182,Spring,49970,49970,0,movies-2015.csv,2015,1.0,0.0
5183,Free Trip to Egypt,49693,49693,0,movies-2019.csv,2019,1.0,0.0
5184,Henchmen 2020 Re-release,49676,49676,0,movies-2020.csv,2020,1.0,0.0
5185,NOW: In the Wings on a World Stage,49591,49591,0,movies-2014.csv,2014,1.0,0.0
5186,Red Herring,49480,49480,0,movies-2015.csv,2015,1.0,0.0
5187,Jumanji/Jumanji: Welcome to the Jungle 2018 NCM Fathom Event,49381,49381,0,movies-2018.csv,2018,1.0,0.0
5188,Shirin in Love,49254,49254,0,movies-2014.csv,2014,1.0,0.0
5189,Bonsai,49128,21267,27861,movies-2012.csv,2012,0.4328895945285784,0.5671104054714216
5190,Hal,49045,48698,347,movies-2018.csv,2018,0.9929248649199715,0.007075135080028545
5191,The Way I See It,49030,49030,0,movies-2020.csv,2020,1.0,0.0
5192,Orgasm Inc.,49001,49001,0,movies-2011.csv,2011,1.0,0.0
5193,Lucky Them,48995,48995,0,movies-2014.csv,2014,1.0,0.0
5194,The Internet's Own Boy: The Story of Aaron Swartz,48911,48911,0,movies-2014.csv,2014,1.0,0.0
5195,The Seven Five,48869,48869,0,movies-2015.csv,2015,1.0,0.0
5196,The Bounty Killer,48815,48815,0,movies-2019.csv,2019,1.0,0.0
5197,The Citizen,48767,24296,24471,movies-2013.csv,2013,0.49820575389095084,0.5017942461090491
5198,A Birder's Guide to Everything,48713,48713,0,movies-2014.csv,2014,1.0,0.0
5199,American Mustang,48700,48700,0,movies-2014.csv,2014,1.0,0.0
5200,The China Hustle,48650,48650,0,movies-2018.csv,2018,1.0,0.0
5201,Person to Person,48499,48499,0,movies-2017.csv,2017,1.0,0.0
5202,Alleluia,48426,6334,42092,movies-2014.csv,2014,0.13079750547226696,0.869202494527733
5203,"Lebanon, Pa.",48381,48381,0,movies-2011.csv,2011,1.0,0.0
5204,Ceremony,48174,22270,25904,movies-2011.csv,2011,0.4622825590567526,0.5377174409432474
5205,The Forbidden Room,48082,34404,13678,movies-2015.csv,2015,0.7155276402811863,0.2844723597188137
5206,Life Happens,48041,30905,17136,movies-2012.csv,2012,0.6433046772548449,0.3566953227451552
5207,A Cop,48040,48040,0,movies-2013.csv,2013,1.0,0.0
5208,Saving Banksy,47965,47965,0,movies-2017.csv,2017,1.0,0.0
5209,The Queen,47818,47818,0,movies-2019.csv,2019,1.0,0.0
5210,Alphaville,47696,47696,0,movies-2014.csv,2014,1.0,0.0
5211,So B. It,47627,47627,0,movies-2017.csv,2017,1.0,0.0
5212,GMO OMG,47558,47558,0,movies-2013.csv,2013,1.0,0.0
5213,350 Days - Legends. Champions. Survivors,47526,47526,0,movies-2018.csv,2018,1.0,0.0
5214,Entre les Bras,47439,47439,0,movies-2012.csv,2012,1.0,0.0
5215,Alabama Moon,47305,47305,0,movies-2011.csv,2011,1.0,0.0
5216,Daughters of the Dust 2016 Re-release,47287,40986,6301,movies-2016.csv,2016,0.8667498466809059,0.13325015331909404
5217,The Raft,47269,39678,7591,movies-2019.csv,2019,0.8394084918233937,0.16059150817660622
5218,Went the Day Well?,47214,47214,0,movies-2011.csv,2011,1.0,0.0
5219,VHYes,47037,47037,0,movies-2020.csv,2020,1.0,0.0
5220,Diary of a Country Priest,47000,47000,0,movies-2011.csv,2011,1.0,0.0
5221,A Master Builder,46874,46874,0,movies-2014.csv,2014,1.0,0.0
5222,Enter the Fat Dragon,46855,46855,0,movies-2020.csv,2020,1.0,0.0
5223,78/52: Hitchcock's Shower Scene,46838,37664,9174,movies-2017.csv,2017,0.8041333959605449,0.19586660403945513
5224,"Connected: An Autoblogography About Love, Death & Technology",46782,46782,0,movies-2011.csv,2011,1.0,0.0
5225,The Woodmans,46623,46623,0,movies-2011.csv,2011,1.0,0.0
5226,Our Time,46433,14777,31656,movies-2019.csv,2019,0.31824349062089463,0.6817565093791054
5227,Shanghai 2015 Re-release,46425,46425,0,movies-2015.csv,2015,1.0,0.0
5228,Patience,46410,15941,30469,movies-2012.csv,2012,0.34348200818789054,0.6565179918121095
5229,Mediterranea,46392,22076,24316,movies-2015.csv,2015,0.4758579065356096,0.5241420934643904
5230,The Bra,46316,7324,38992,movies-2019.csv,2019,0.15813109940409362,0.8418689005959064
5231,Greedy Lying Bastards,46121,45000,1121,movies-2012.csv,2012,0.9756943691593851,0.024305630840614906
5232,Ballplayer: Pelotero,46109,46109,0,movies-2012.csv,2012,1.0,0.0
5233,Panique,46041,46041,0,movies-2017.csv,2017,1.0,0.0
5234,Every Day,46029,46029,0,movies-2011.csv,2011,1.0,0.0
5235,Monk with a Camera,45938,45938,0,movies-2014.csv,2014,1.0,0.0
5236,Maurice 2017 Re-release,45926,45926,0,movies-2017.csv,2017,1.0,0.0
5237,High on the Hog,45696,45696,0,movies-2019.csv,2019,1.0,0.0
5238,Eddie: The Sleepwalking Cannibal,45604,1632,43972,movies-2012.csv,2012,0.035786334532058595,0.9642136654679414
5239,3 Weeks in Yerevan,45536,45536,0,movies-2016.csv,2016,1.0,0.0
5240,An Eye for Beauty,45513,9395,36118,movies-2015.csv,2015,0.20642453804407532,0.7935754619559247
5241,Mercury,45429,0,45429,movies-2018.csv,2018,0.0,1.0
5242,Return to the Hiding Place,45405,45405,0,movies-2014.csv,2014,1.0,0.0
5243,Ai Weiwei: The Fake Case,45255,45255,0,movies-2014.csv,2014,1.0,0.0
5244,There's No Place Like Utopia,45254,45254,0,movies-2014.csv,2014,1.0,0.0
5245,CornerStore,45176,45176,0,movies-2011.csv,2011,1.0,0.0
5246,American Made Movie,45175,45175,0,movies-2013.csv,2013,1.0,0.0
5247,The Proposal,45149,45149,0,movies-2019.csv,2019,1.0,0.0
5248,The Farthest,44921,14773,30148,movies-2017.csv,2017,0.32886623182921126,0.6711337681707887
5249,Celebration,44898,22557,22341,movies-2019.csv,2019,0.5024054523586797,0.49759454764132033
5250,The Pruitt-Igoe Myth,44883,44883,0,movies-2012.csv,2012,1.0,0.0
5251,River of Fundament,44840,44840,0,movies-2015.csv,2015,1.0,0.0
5252,Union Square,44830,44830,0,movies-2012.csv,2012,1.0,0.0
5253,That Summer,44659,34556,10103,movies-2018.csv,2018,0.7737746031035178,0.22622539689648224
5254,The Dog,44581,44581,0,movies-2014.csv,2014,1.0,0.0
5255,The Bride Wore Black,44566,44566,0,movies-2011.csv,2011,1.0,0.0
5256,What Is Democracy?,44536,44536,0,movies-2019.csv,2019,1.0,0.0
5257,"Léon Morin, Priest 2017 Re-release",44511,44511,0,movies-2017.csv,2017,1.0,0.0
5258,Maze 2019 Re-release,44381,44381,0,movies-2019.csv,2019,1.0,0.0
5259,What You Gonna Do When the World's on Fire?,44290,4672,39618,movies-2019.csv,2019,0.10548656581621134,0.8945134341837887
5260,Carmine Street Guitars,44253,44253,0,movies-2019.csv,2019,1.0,0.0
5261,Slut in a Good Way,44240,40513,3727,movies-2019.csv,2019,0.915754972875226,0.08424502712477396
5262,Nuts!,44230,44230,0,movies-2016.csv,2016,1.0,0.0
5263,Danny Says,44213,44213,0,movies-2016.csv,2016,1.0,0.0
5264,Life of a King,44161,6547,37614,movies-2014.csv,2014,0.14825298340164397,0.851747016598356
5265,Hermia & Helena,44156,43152,1004,movies-2017.csv,2017,0.9772624331914123,0.022737566808587736
5266,Submission,44069,39985,4084,movies-2018.csv,2018,0.9073271460663959,0.09267285393360412
5267,Liyana,44045,44045,0,movies-2018.csv,2018,1.0,0.0
5268,Garry Winogrand: All Things are Photographable,44002,44002,0,movies-2018.csv,2018,1.0,0.0
5269,Granito,43942,43942,0,movies-2011.csv,2011,1.0,0.0
5270,Spree,43840,28771,15069,movies-2020.csv,2020,0.6562728102189781,0.3437271897810219
5271,Summer 2011 Re-release,43839,43839,0,movies-2011.csv,2011,1.0,0.0
5272,Hitler's Hollywood,43766,43766,0,movies-2018.csv,2018,1.0,0.0
5273,Contempt 2013 Re-release,43763,43763,0,movies-2013.csv,2013,1.0,0.0
5274,Bad Blood 2013 Re-release,43758,35176,8582,movies-2013.csv,2013,0.8038758626993922,0.19612413730060788
5275,The Land,43756,43756,0,movies-2016.csv,2016,1.0,0.0
5276,Bereavement,43712,43712,0,movies-2011.csv,2011,1.0,0.0
5277,Woodshock,43682,42603,1079,movies-2017.csv,2017,0.9752987500572318,0.024701249942768188
5278,Love Etc.,43593,43593,0,movies-2011.csv,2011,1.0,0.0
5279,"OC87: The Obsessive Compulsive, Major Depression, Bipolar, Asperger's Movie",43583,43583,0,movies-2012.csv,2012,1.0,0.0
5280,The Graduate 45th Anniversary Reunion,43466,43466,0,movies-2012.csv,2012,1.0,0.0
5281,If You Build It,43393,43393,0,movies-2014.csv,2014,1.0,0.0
5282,The Empire of Corpses,43320,0,43320,movies-2016.csv,2016,0.0,1.0
5283,Next Goal Wins,43089,43089,0,movies-2014.csv,2014,1.0,0.0
5284,3 Backyards,43073,43073,0,movies-2011.csv,2011,1.0,0.0
5285,Jenny's Wedding,42927,4704,38223,movies-2015.csv,2015,0.10958138234677475,0.8904186176532253
5286,Andre Gregory: Before and After Dinner,42892,42892,0,movies-2013.csv,2013,1.0,0.0
5287,First We Take Brooklyn,42812,42812,0,movies-2018.csv,2018,1.0,0.0
5288,Interior. Leather Bar.,42534,42534,0,movies-2014.csv,2014,1.0,0.0
5289,Last Call at the Oasis,42423,42423,0,movies-2012.csv,2012,1.0,0.0
5290,Fixing the Future,42393,42393,0,movies-2012.csv,2012,1.0,0.0
5291,Closet Monster,42360,42166,194,movies-2016.csv,2016,0.9954202077431539,0.004579792256846081
5292,Down for Life,41914,41914,0,movies-2011.csv,2011,1.0,0.0
5293,In Pursuit of Silence,41913,29834,12079,movies-2016.csv,2016,0.7118077923317347,0.2881922076682652
5294,Golden Exits,41888,41888,0,movies-2018.csv,2018,1.0,0.0
5295,The Nightmare,41853,28281,13572,movies-2015.csv,2015,0.675722170453731,0.3242778295462691
5296,The Road Within,41760,0,41760,movies-2015.csv,2015,0.0,1.0
5297,Union,41656,41656,0,movies-2019.csv,2019,1.0,0.0
5298,Kalakalappu,41624,30949,10675,movies-2012.csv,2012,0.7435373822794542,0.25646261772054585
5299,Death of a Superhero,41575,607,40968,movies-2012.csv,2012,0.014600120264582081,0.9853998797354179
5300,The Settlers,41562,41562,0,movies-2017.csv,2017,1.0,0.0
5301,Jonathan,41558,0,41558,movies-2018.csv,2018,0.0,1.0
5302,Holla II,41537,41537,0,movies-2013.csv,2013,1.0,0.0
5303,Censored Voices,41260,41260,0,movies-2015.csv,2015,1.0,0.0
5304,Dark Light,41240,0,41240,movies-2019.csv,2019,0.0,1.0
5305,Steve McQueen: The Man & Le Mans,41203,6843,34360,movies-2015.csv,2015,0.16608013979564595,0.833919860204354
5306,The Comedy,41113,41113,0,movies-2012.csv,2012,1.0,0.0
5307,Karl Marx City,41072,41072,0,movies-2017.csv,2017,1.0,0.0
5308,Blue Iguana,41050,0,41050,movies-2018.csv,2018,0.0,1.0
5309,The Myth of the American Sleepover,41045,41045,0,movies-2011.csv,2011,1.0,0.0
5310,Fat Kid Rules the World,41000,41000,0,movies-2012.csv,2012,1.0,0.0
5311,Why Don't You Just Die!,40995,0,40995,movies-2019.csv,2019,0.0,1.0
5312,Hell and Back Again,40949,40634,315,movies-2011.csv,2011,0.9923075044567633,0.007692495543236709
5313,Found Memories,40729,10575,30154,movies-2012.csv,2012,0.25964300621179015,0.7403569937882098
5314,Language of a Broken Heart,40645,40645,0,movies-2013.csv,2013,1.0,0.0
5315,Mercedes Sosa: The Voice of Latin America,40643,2648,37995,movies-2013.csv,2013,0.06515267081662279,0.9348473291833772
5316,Life and Nothing More,40581,24358,16223,movies-2017.csv,2017,0.6002316354944432,0.3997683645055568
5317,The FP,40557,40557,0,movies-2012.csv,2012,1.0,0.0
5318,CBGB,40400,40400,0,movies-2013.csv,2013,1.0,0.0
5319,Belle de Jour 2017 Re-release,40382,26331,14051,movies-2017.csv,2017,0.6520479421524441,0.34795205784755584
5320,Of Mind and Music,40322,15073,25249,movies-2016.csv,2016,0.37381578294727447,0.6261842170527255
5321,Paan Singh Tomar,40311,40311,0,movies-2012.csv,2012,1.0,0.0
5322,Teenage,40169,40169,0,movies-2014.csv,2014,1.0,0.0
5323,On Her Shoulders,40145,28288,11857,movies-2018.csv,2018,0.7046456594843692,0.29535434051563086
5324,Aniara,40124,40124,0,movies-2019.csv,2019,1.0,0.0
5325,Addiction Incorporated,40106,40106,0,movies-2011.csv,2011,1.0,0.0
5326,Humor Me,40099,40099,0,movies-2018.csv,2018,1.0,0.0
5327,Unrest,40081,40081,0,movies-2017.csv,2017,1.0,0.0
5328,Louder Than a Bomb,40000,40000,0,movies-2011.csv,2011,1.0,0.0
5329,Is That a Gun in Your Pocket?,39928,39928,0,movies-2016.csv,2016,1.0,0.0
5330,Divine Love,39920,0,39920,movies-2019.csv,2019,0.0,1.0
5331,The Short Game,39819,39819,0,movies-2013.csv,2013,1.0,0.0
5332,Plot for Peace,39811,7051,32760,movies-2013.csv,2013,0.17711185350782446,0.8228881464921756
5333,Port of Shadows,39623,27389,12234,movies-2012.csv,2012,0.6912399364005755,0.3087600635994246
5334,An Elephant Sitting Still,39599,32556,7043,movies-2018.csv,2018,0.8221419732821535,0.17785802671784642
5335,The Homeless Billionaire,39493,39493,0,movies-2016.csv,2016,1.0,0.0
5336,Juvenile Delinquents,39455,34292,5163,movies-2020.csv,2020,0.869142060575339,0.130857939424661
5337,Prophet's Prey,39347,39347,0,movies-2015.csv,2015,1.0,0.0
5338,Child of God,39324,39324,0,movies-2014.csv,2014,1.0,0.0
5339,"3 1/2 Minutes, 10 Bullets",39263,30407,8856,movies-2015.csv,2015,0.7744441331533505,0.22555586684664952
5340,La Notte,39236,39236,0,movies-2016.csv,2016,1.0,0.0
5341,Where Soldiers Come From,39201,39201,0,movies-2011.csv,2011,1.0,0.0
5342,How to Make Money Selling Drugs,39192,39192,0,movies-2013.csv,2013,1.0,0.0
5343,I Do Not Care If We Go Down in History as Barbarians,39171,11307,27864,movies-2018.csv,2018,0.2886574251359424,0.7113425748640576
5344,The Expedition to the End of the World,39115,39115,0,movies-2014.csv,2014,1.0,0.0
5345,Zilla and Zoe,39003,39003,0,movies-2019.csv,2019,1.0,0.0
5346,I Used to Be Darker,38974,22214,16760,movies-2013.csv,2013,0.5699697234053471,0.43003027659465287
5347,Herb & Dorothy 50X50,38933,38933,0,movies-2013.csv,2013,1.0,0.0
5348,Shed of the Dead,38901,38901,0,movies-2019.csv,2019,1.0,0.0
5349,The Son of Joseph,38774,30588,8186,movies-2016.csv,2016,0.7888791458193635,0.2111208541806365
5350,Restored Me,38745,38745,0,movies-2016.csv,2016,1.0,0.0
5351,Paul Williams Still Alive,38691,38691,0,movies-2012.csv,2012,1.0,0.0
5352,Catching the Sun,38613,38613,0,movies-2016.csv,2016,1.0,0.0
5353,Spa Night,38578,38578,0,movies-2016.csv,2016,1.0,0.0
5354,Troublemakers: The Story of Land Art,38571,29462,9109,movies-2016.csv,2016,0.7638381167198154,0.2361618832801846
5355,Divide and Conquer,38510,38510,0,movies-2018.csv,2018,1.0,0.0
5356,Death by China,38492,38492,0,movies-2012.csv,2012,1.0,0.0
5357,Multiple Maniacs,38403,33036,5367,movies-2016.csv,2016,0.860245293336458,0.13975470666354192
5358,Araby,38399,38399,0,movies-2018.csv,2018,1.0,0.0
5359,Batman Forever 2019 Re-release,38387,38014,373,movies-2019.csv,2019,0.9902831687810978,0.009716831218902232
5360,The Blackcoat's Daughter,38348,20435,17913,movies-2017.csv,2017,0.5328830708250756,0.46711692917492437
5361,Policeman,38263,11263,27000,movies-2013.csv,2013,0.29435747327705614,0.7056425267229438
5362,No Intenso Agora,38223,24955,13268,movies-2018.csv,2018,0.6528791565287916,0.3471208434712084
5363,Germans & Jews,38100,38100,0,movies-2016.csv,2016,1.0,0.0
5364,Gray Matter,38034,38034,0,movies-2018.csv,2018,1.0,0.0
5365,Moscow Never Sleeps,38004,25306,12698,movies-2016.csv,2016,0.6658772760762025,0.3341227239237975
5366,Band of Outsiders 2016 Re-release,38004,38004,0,movies-2016.csv,2016,1.0,0.0
5367,The Crime of Monsieur Lange,38002,36438,1564,movies-2017.csv,2017,0.9588442713541393,0.04115572864586074
5368,Russian Ark 2013 Re-release,37984,37984,0,movies-2013.csv,2013,1.0,0.0
5369,Adult World,37887,25368,12519,movies-2014.csv,2014,0.6695700372159316,0.3304299627840684
5370,I Am the Blues,37849,37849,0,movies-2017.csv,2017,1.0,0.0
5371,The Heart of Nuba,37788,37788,0,movies-2018.csv,2018,1.0,0.0
5372,Out 1,37743,31539,6204,movies-2015.csv,2015,0.835625149034258,0.164374850965742
5373,Mumia: Long Distance Revolutionary,37731,37731,0,movies-2013.csv,2013,1.0,0.0
5374,Krystal,37516,37516,0,movies-2018.csv,2018,1.0,0.0
5375,News from Planet Mars,37507,310,37197,movies-2016.csv,2016,0.008265123843549204,0.9917348761564508
5376,Big Sur,37466,37466,0,movies-2013.csv,2013,1.0,0.0
5377,Match 2015 Re-release,37285,37285,0,movies-2015.csv,2015,1.0,0.0
5378,Memory: The Origins of Alien,37272,31378,5894,movies-2019.csv,2019,0.8418652071259927,0.1581347928740073
5379,Savannah,37240,37240,0,movies-2013.csv,2013,1.0,0.0
5380,Small Group,37058,37058,0,movies-2018.csv,2018,1.0,0.0
5381,24 Frames,37045,34482,2563,movies-2018.csv,2018,0.9308138750168714,0.06918612498312862
5382,The Quiet One,37010,37010,0,movies-2019.csv,2019,1.0,0.0
5383,Children of Paradise 2012 Re-release,36986,36986,0,movies-2012.csv,2012,1.0,0.0
5384,Grey Gardens,36923,36923,0,movies-2015.csv,2015,1.0,0.0
5385,Trust Fund,36885,36885,0,movies-2016.csv,2016,1.0,0.0
5386,The Death of Dick Long,36856,36856,0,movies-2019.csv,2019,1.0,0.0
5387,Three Christs,36723,36723,0,movies-2020.csv,2020,1.0,0.0
5388,Sister Code,36676,36676,0,movies-2015.csv,2015,1.0,0.0
5389,Mind Game,36613,36613,0,movies-2018.csv,2018,1.0,0.0
5390,Bending the Arc,36586,21907,14679,movies-2017.csv,2017,0.5987809544634559,0.40121904553654403
5391,Yoga Hosers,36585,0,36585,movies-2016.csv,2016,0.0,1.0
5392,Hit So Hard,36576,34025,2551,movies-2012.csv,2012,0.9302548118985127,0.06974518810148732
5393,Tread,36527,36527,0,movies-2020.csv,2020,1.0,0.0
5394,For Those Who Don't Read Me,36506,36506,0,movies-2018.csv,2018,1.0,0.0
5395,The Servant,36463,36463,0,movies-2013.csv,2013,1.0,0.0
5396,Waiting for Anya,36404,0,36404,movies-2020.csv,2020,0.0,1.0
5397,Unexpected,36402,23986,12416,movies-2015.csv,2015,0.6589198395692545,0.34108016043074557
5398,How to Let Go of the World: and Love All the Things Climate Can't Change,36386,36386,0,movies-2016.csv,2016,1.0,0.0
5399,Welcome to Leith,36380,36010,370,movies-2015.csv,2015,0.9898295766904893,0.01017042330951072
5400,Mansome,36280,36280,0,movies-2012.csv,2012,1.0,0.0
5401,Loro,36183,35613,570,movies-2019.csv,2019,0.984246745709311,0.015753254290689
5402,Loosies,36145,3519,32626,movies-2012.csv,2012,0.09735786415825148,0.9026421358417485
5403,Touchy Feely,36128,36128,0,movies-2013.csv,2013,1.0,0.0
5404,Le Corbeau,36089,36089,0,movies-2018.csv,2018,1.0,0.0
5405,Brimstone & Glory,36036,32059,3977,movies-2017.csv,2017,0.8896381396381396,0.11036186036186037
5406,"Kill Me, Deadly",36027,36027,0,movies-2016.csv,2016,1.0,0.0
5407,Not Cool,36026,36026,0,movies-2014.csv,2014,1.0,0.0
5408,Almost Friends,35842,1481,34361,movies-2017.csv,2017,0.04132023882595837,0.9586797611740416
5409,The House of Tomorrow,35821,35821,0,movies-2018.csv,2018,1.0,0.0
5410,Bangkok Revenge,35784,35784,0,movies-2012.csv,2012,1.0,0.0
5411,The Road Movie,35757,35757,0,movies-2018.csv,2018,1.0,0.0
5412,Good Manners,35714,31177,4537,movies-2018.csv,2018,0.8729629837038696,0.12703701629613037
5413,Paul Goodman Changed My Life,35671,35671,0,movies-2011.csv,2011,1.0,0.0
5414,Far Out Isn't Far Enough: The Tomi Ungerer Story,35647,35647,0,movies-2013.csv,2013,1.0,0.0
5415,M 2013 Re-release,35566,35566,0,movies-2013.csv,2013,1.0,0.0
5416,Finders Keepers,35555,35555,0,movies-2015.csv,2015,1.0,0.0
5417,PGS: Intuition Is Your Personal Guidance System,35423,35423,0,movies-2018.csv,2018,1.0,0.0
5418,Kinyarwanda,35412,35412,0,movies-2011.csv,2011,1.0,0.0
5419,Max and the Junkmen,35387,35387,0,movies-2012.csv,2012,1.0,0.0
5420,Le Jour Se Leve,35321,35321,0,movies-2014.csv,2014,1.0,0.0
5421,Growing Up Smith,35312,35312,0,movies-2017.csv,2017,1.0,0.0
5422,The Decent One,35282,21327,13955,movies-2014.csv,2014,0.6044725355705459,0.39552746442945413
5423,Underdogs,35271,35271,0,movies-2013.csv,2013,1.0,0.0
5424,Rat Film,35195,35195,0,movies-2017.csv,2017,1.0,0.0
5425,Ága,35178,35178,0,movies-2019.csv,2019,1.0,0.0
5426,That Man from Rio,35144,35144,0,movies-2014.csv,2014,1.0,0.0
5427,When Harry Tries to Marry,35100,35100,0,movies-2011.csv,2011,1.0,0.0
5428,The Girl,35048,35048,0,movies-2013.csv,2013,1.0,0.0
5429,Beneath the Harvest Sky,34768,34768,0,movies-2014.csv,2014,1.0,0.0
5430,This Ain't No Mouse Music,34754,34754,0,movies-2014.csv,2014,1.0,0.0
5431,Comic-Con Episode IV: A Fan's Hope,34665,34665,0,movies-2012.csv,2012,1.0,0.0
5432,The Old Dark House,34649,25678,8971,movies-2017.csv,2017,0.7410892089237785,0.25891079107622156
5433,Sophie and the Rising Sun,34630,34630,0,movies-2017.csv,2017,1.0,0.0
5434,Le Trou,34588,34588,0,movies-2017.csv,2017,1.0,0.0
5435,Orchestra of Exiles,34577,34577,0,movies-2012.csv,2012,1.0,0.0
5436,Rakuen Tsuiho: Expelled from Paradise,34510,34510,0,movies-2014.csv,2014,1.0,0.0
5437,Cosmos,34393,25856,8537,movies-2015.csv,2015,0.7517808856453349,0.2482191143546652
5438,Pierrot le Fou 2015 Re-release,34371,34371,0,movies-2015.csv,2015,1.0,0.0
5439,Holy Hell,34366,34366,0,movies-2018.csv,2018,1.0,0.0
5440,Off the Rails,34249,34249,0,movies-2016.csv,2016,1.0,0.0
5441,Rocks in My Pockets,34236,34236,0,movies-2014.csv,2014,1.0,0.0
5442,Just Like a Woman,34206,11403,22803,movies-2013.csv,2013,0.3333625679705315,0.6666374320294686
5443,Dave Made a Maze,34117,34117,0,movies-2017.csv,2017,1.0,0.0
5444,Beautiful Darling,34096,34096,0,movies-2011.csv,2011,1.0,0.0
5445,Kilo Two Bravo,34017,7891,26126,movies-2015.csv,2015,0.23197224916953288,0.7680277508304671
5446,Bert Stern: Original Madman,34005,34005,0,movies-2013.csv,2013,1.0,0.0
5447,RBG 2020 Re-release,34000,34000,0,movies-2020.csv,2020,1.0,0.0
5448,Maui,33953,33953,0,movies-2018.csv,2018,1.0,0.0
5449,Killer Unicorn,33901,33901,0,movies-2019.csv,2019,1.0,0.0
5450,Moonlight Sonata: Deafness in Three Movements,33823,33823,0,movies-2019.csv,2019,1.0,0.0
5451,It Felt Like Love,33817,33817,0,movies-2014.csv,2014,1.0,0.0
5452,Closed Curtain,33735,28098,5637,movies-2014.csv,2014,0.8329035126722988,0.1670964873277012
5453,Below Her Mouth,33673,0,33673,movies-2017.csv,2017,0.0,1.0
5454,Shooting the Mafia,33547,10881,22666,movies-2019.csv,2019,0.3243509106626524,0.6756490893373476
5455,Making the Boys,33443,33443,0,movies-2011.csv,2011,1.0,0.0
5456,The Winding Stream,33420,33420,0,movies-2015.csv,2015,1.0,0.0
5457,Final Girl,33411,0,33411,movies-2015.csv,2015,0.0,1.0
5458,"Distant Voices, Still Lives 2018 Re-release",33301,5234,28067,movies-2018.csv,2018,0.15717245728356505,0.8428275427164349
5459,Running from Crazy,33300,33300,0,movies-2013.csv,2013,1.0,0.0
5460,Wasted! The Story of Food Waste,33211,33211,0,movies-2017.csv,2017,1.0,0.0
5461,Redoubt,33155,33155,0,movies-2019.csv,2019,1.0,0.0
5462,Love & Taxes,33150,33150,0,movies-2017.csv,2017,1.0,0.0
5463,American Teacher,33144,33144,0,movies-2011.csv,2011,1.0,0.0
5464,Super Dark Times,33109,33109,0,movies-2017.csv,2017,1.0,0.0
5465,Dislecksia: The Movie,33066,33066,0,movies-2013.csv,2013,1.0,0.0
5466,Meet Monica Velour,33042,33042,0,movies-2011.csv,2011,1.0,0.0
5467,Albatross,32992,0,32992,movies-2011.csv,2011,0.0,1.0
5468,Being Charlie,32964,30400,2564,movies-2016.csv,2016,0.9222181774056547,0.07778182259434535
5469,The Intervention,32919,32919,0,movies-2016.csv,2016,1.0,0.0
5470,No Home Movie,32757,32757,0,movies-2016.csv,2016,1.0,0.0
5471,The Nun,32659,30245,2414,movies-2018.csv,2018,0.9260846933463976,0.07391530665360238
5472,Sollers Point,32608,32608,0,movies-2018.csv,2018,1.0,0.0
5473,The Day I Saw Your Heart 2012 Re-release,32567,3546,29021,movies-2012.csv,2012,0.10888322535081524,0.8911167746491847
5474,Spettacolo,32494,32494,0,movies-2017.csv,2017,1.0,0.0
5475,Rurouni Kenshin Part I: Origins 2016 Re-release,32445,32445,0,movies-2016.csv,2016,1.0,0.0
5476,An Acceptable Loss,32427,32427,0,movies-2019.csv,2019,1.0,0.0
5477,10E,32413,32413,0,movies-2019.csv,2019,1.0,0.0
5478,The Hero of Color City,32188,32188,0,movies-2014.csv,2014,1.0,0.0
5479,Goodland,32140,32140,0,movies-2018.csv,2018,1.0,0.0
5480,Desolation Center,32016,32016,0,movies-2019.csv,2019,1.0,0.0
5481,"Rio, I Love You 2016 Re-release",31982,31982,0,movies-2016.csv,2016,1.0,0.0
5482,Moynihan,31970,31970,0,movies-2018.csv,2018,1.0,0.0
5483,District of Corruption,31954,31954,0,movies-2012.csv,2012,1.0,0.0
5484,Amira & Sam,31849,31849,0,movies-2015.csv,2015,1.0,0.0
5485,Paths of the Soul,31747,31747,0,movies-2016.csv,2016,1.0,0.0
5486,At Berkeley,31736,31736,0,movies-2013.csv,2013,1.0,0.0
5487,Aurora,31720,5677,26043,movies-2011.csv,2011,0.1789722572509458,0.8210277427490542
5488,Gift,31588,31588,0,movies-2019.csv,2019,1.0,0.0
5489,Signature Move,31551,31551,0,movies-2017.csv,2017,1.0,0.0
5490,The Cat Rescuers,31540,31540,0,movies-2019.csv,2019,1.0,0.0
5491,The Passionate Thief,31539,31539,0,movies-2014.csv,2014,1.0,0.0
5492,Musical Chairs,31478,31478,0,movies-2012.csv,2012,1.0,0.0
5493,Celine and Julie Go Boating,31452,31452,0,movies-2012.csv,2012,1.0,0.0
5494,Beyond the Farthest Star,31433,31433,0,movies-2013.csv,2013,1.0,0.0
5495,Here,31428,26743,4685,movies-2012.csv,2012,0.8509291078019601,0.14907089219803996
5496,Sidemen: Long Road to Glory,31399,31399,0,movies-2017.csv,2017,1.0,0.0
5497,Don Verdean,31309,31309,0,movies-2015.csv,2015,1.0,0.0
5498,Buddy,31203,31203,0,movies-2019.csv,2019,1.0,0.0
5499,"Hey, Boo: Harper Lee and 'To Kill a Mockingbird'",31135,31135,0,movies-2011.csv,2011,1.0,0.0
5500,Small Town Murder Songs,31133,31133,0,movies-2011.csv,2011,1.0,0.0
5501,7 Witches,31100,31100,0,movies-2017.csv,2017,1.0,0.0
5502,White Irish Drinkers,31056,31056,0,movies-2011.csv,2011,1.0,0.0
5503,Rent-A-Pal,31053,30901,152,movies-2020.csv,2020,0.9951051428203395,0.0048948571796605805
5504,Poor Boy,31031,31031,0,movies-2018.csv,2018,1.0,0.0
5505,"2 Autumns, 3 Winters",30985,5819,25166,movies-2014.csv,2014,0.18780054865257384,0.8121994513474262
5506,The Seventh Fire,30977,30112,865,movies-2016.csv,2016,0.9720760564289634,0.027923943571036575
5507,Lamb,30844,14547,16297,movies-2016.csv,2016,0.47163143561146414,0.5283685643885359
5508,Meet the Fokkens,30810,30810,0,movies-2012.csv,2012,1.0,0.0
5509,Pasolini 2019 Re-release,30757,30757,0,movies-2019.csv,2019,1.0,0.0
5510,Documented,30662,30662,0,movies-2014.csv,2014,1.0,0.0
5511,Hide Away,30655,30655,0,movies-2012.csv,2012,1.0,0.0
5512,The Chaperone,30514,0,30514,movies-2011.csv,2011,0.0,1.0
5513,After Parkland,30444,30444,0,movies-2020.csv,2020,1.0,0.0
5514,Los Reyes,30418,30418,0,movies-2019.csv,2019,1.0,0.0
5515,Dealt,30414,30414,0,movies-2017.csv,2017,1.0,0.0
5516,These Birds Walk,30408,30408,0,movies-2013.csv,2013,1.0,0.0
5517,"Hare Krishna! The Mantra, the Movement and the Swami Who Started It 2017 Re-release",30380,19278,11102,movies-2017.csv,2017,0.6345622119815668,0.3654377880184332
5518,Heavy Trip,30351,10153,20198,movies-2018.csv,2018,0.33451945570162434,0.6654805442983757
5519,Happy Christmas,30312,30312,0,movies-2014.csv,2014,1.0,0.0
5520,No Greater Love,30247,30247,0,movies-2017.csv,2017,1.0,0.0
5521,Cold Water,30209,30209,0,movies-2018.csv,2018,1.0,0.0
5522,Army of Shadows 2015 Re-release,30190,30190,0,movies-2015.csv,2015,1.0,0.0
5523,Runoff,30186,30186,0,movies-2015.csv,2015,1.0,0.0
5524,Paul Taylor: Creative Domain,30168,30168,0,movies-2015.csv,2015,1.0,0.0
5525,Southern Baptist Sissies,30160,30160,0,movies-2014.csv,2014,1.0,0.0
5526,Lionel Richie at Glastonbury,30123,30123,0,movies-2019.csv,2019,1.0,0.0
5527,Therapy for a Vampire 2016 Re-release,30115,30115,0,movies-2016.csv,2016,1.0,0.0
5528,A Long Way Off,30104,30104,0,movies-2014.csv,2014,1.0,0.0
5529,Manakamana,30029,30029,0,movies-2014.csv,2014,1.0,0.0
5530,Cat Run,30000,30000,0,movies-2011.csv,2011,1.0,0.0
5531,Evidence of a Haunting,29904,29904,0,movies-2011.csv,2011,1.0,0.0
5532,Brother 2012 Re-release,29864,29864,0,movies-2012.csv,2012,1.0,0.0
5533,Long Shot: The Kevin Laue Story 2013 Re-release,29863,29863,0,movies-2013.csv,2013,1.0,0.0
5534,A Fierce Green Fire: The Battle for A Living Planet,29817,29817,0,movies-2013.csv,2013,1.0,0.0
5535,Uncertain,29736,29736,0,movies-2017.csv,2017,1.0,0.0
5536,Yellow Day,29656,29656,0,movies-2014.csv,2014,1.0,0.0
5537,Memories of Underdevelopment 2018 Re-release,29647,29647,0,movies-2018.csv,2018,1.0,0.0
5538,The Perfect Race,29644,29644,0,movies-2019.csv,2019,1.0,0.0
5539,Dead Man's Burden,29634,29634,0,movies-2013.csv,2013,1.0,0.0
5540,The Eyes of My Mother,29539,27099,2440,movies-2016.csv,2016,0.9173973391110057,0.0826026608889942
5541,Little Fugitive 2013 Re-release,29505,29505,0,movies-2013.csv,2013,1.0,0.0
5542,The Best Democracy Money Can Buy,29500,29500,0,movies-2016.csv,2016,1.0,0.0
5543,The Dog Wedding,29495,29495,0,movies-2016.csv,2016,1.0,0.0
5544,Olympic Dreams,29450,29450,0,movies-2020.csv,2020,1.0,0.0
5545,Redemption Road,29384,29384,0,movies-2011.csv,2011,1.0,0.0
5546,Cousin Jules,29337,29337,0,movies-2013.csv,2013,1.0,0.0
5547,Charm City,29335,29335,0,movies-2018.csv,2018,1.0,0.0
5548,The Topp Twins: Untouchable Girls 2011 Re-release,29316,29316,0,movies-2011.csv,2011,1.0,0.0
5549,Lemon,29258,29258,0,movies-2017.csv,2017,1.0,0.0
5550,The Ground Beneath My Feet,29251,29251,0,movies-2019.csv,2019,1.0,0.0
5551,Time to Choose,29233,29233,0,movies-2016.csv,2016,1.0,0.0
5552,Buffaloed,29118,29118,0,movies-2020.csv,2020,1.0,0.0
5553,Fire in the Blood,28994,28994,0,movies-2013.csv,2013,1.0,0.0
5554,Othello,28980,28980,0,movies-2014.csv,2014,1.0,0.0
5555,Plush,28864,3080,25784,movies-2013.csv,2013,0.10670731707317073,0.8932926829268293
5556,Batman & Robin 2019 Re-release,28793,28597,196,movies-2019.csv,2019,0.9931927899142152,0.00680721008578474
5557,Rebels of the Neon God,28791,28791,0,movies-2015.csv,2015,1.0,0.0
5558,Americons,28782,28782,0,movies-2015.csv,2015,1.0,0.0
5559,Hitler's Children,28663,28663,0,movies-2012.csv,2012,1.0,0.0
5560,Abe,28657,0,28657,movies-2020.csv,2020,0.0,1.0
5561,The Transfiguration,28631,22091,6540,movies-2017.csv,2017,0.771576263490622,0.22842373650937794
5562,Garbo: El espía 2011 Re-release,28563,28563,0,movies-2011.csv,2011,1.0,0.0
5563,Restoring Tomorrow,28556,28556,0,movies-2018.csv,2018,1.0,0.0
5564,Stations of the Elevated,28516,28516,0,movies-2014.csv,2014,1.0,0.0
5565,Carrie Pilby,28430,18957,9473,movies-2017.csv,2017,0.6667956384101301,0.3332043615898699
5566,"Rabin, the Last Day",28411,28411,0,movies-2016.csv,2016,1.0,0.0
5567,The Load,28410,28410,0,movies-2019.csv,2019,1.0,0.0
5568,Struck by Lightning,28378,28378,0,movies-2013.csv,2013,1.0,0.0
5569,The Strange Ones,28374,0,28374,movies-2017.csv,2017,0.0,1.0
5570,North Sea Texas 2012 Re-release,28307,28307,0,movies-2012.csv,2012,1.0,0.0
5571,Arabian Nights: Volume 1 - The Restless One,28245,12260,15985,movies-2015.csv,2015,0.43405912550893966,0.5659408744910603
5572,"Like Sunday, Like Rain",28208,28208,0,movies-2015.csv,2015,1.0,0.0
5573,7 Chinese Brothers,28180,28180,0,movies-2015.csv,2015,1.0,0.0
5574,The Ambassador,28102,28102,0,movies-2012.csv,2012,1.0,0.0
5575,Bikes vs Cars,28072,28072,0,movies-2015.csv,2015,1.0,0.0
5576,Sembene!,28059,28059,0,movies-2015.csv,2015,1.0,0.0
5577,Take Me to the River,28041,28041,0,movies-2016.csv,2016,1.0,0.0
5578,Least Among Saints,28026,28026,0,movies-2012.csv,2012,1.0,0.0
5579,Quai des Orfèvres 2018 Re-release,28013,28013,0,movies-2018.csv,2018,1.0,0.0
5580,The Amendment,27961,27961,0,movies-2018.csv,2018,1.0,0.0
5581,Ribbons,27959,27959,0,movies-2017.csv,2017,1.0,0.0
5582,El Norte 2019 Re-release,27920,27920,0,movies-2019.csv,2019,1.0,0.0
5583,Radio Dreams,27836,27836,0,movies-2017.csv,2017,1.0,0.0
5584,Bauhaus Spirit: 100 Years of Bauhaus,27768,17122,10646,movies-2019.csv,2019,0.6166090463843272,0.3833909536156727
5585,Simon Killer,27740,27740,0,movies-2013.csv,2013,1.0,0.0
5586,30 Years of Garbage: The Garbage Pail Kids Story,27739,27739,0,movies-2017.csv,2017,1.0,0.0
5587,Senso,27723,27723,0,movies-2018.csv,2018,1.0,0.0
5588,Broadway Idiot,27595,27595,0,movies-2013.csv,2013,1.0,0.0
5589,The King and the Mockingbird 2014 Re-release,27513,27513,0,movies-2014.csv,2014,1.0,0.0
5590,Kate Plays Christine,27364,25564,1800,movies-2016.csv,2016,0.9342201432539102,0.06577985674608976
5591,Cane River 2020 Re-release,27317,27317,0,movies-2020.csv,2020,1.0,0.0
5592,Unlocking the Cage,27284,27284,0,movies-2016.csv,2016,1.0,0.0
5593,Tiger Eyes,27160,27160,0,movies-2013.csv,2013,1.0,0.0
5594,Bronx Gothic,27151,27151,0,movies-2017.csv,2017,1.0,0.0
5595,"Leaving Home, Coming Home: A Portrait of Robert Frank",27073,27073,0,movies-2019.csv,2019,1.0,0.0
5596,Last Weekend,27053,27053,0,movies-2014.csv,2014,1.0,0.0
5597,Clash,27052,27052,0,movies-2011.csv,2011,1.0,0.0
5598,Level Five,27000,27000,0,movies-2014.csv,2014,1.0,0.0
5599,The Last Ride,27000,27000,0,movies-2011.csv,2011,1.0,0.0
5600,Mali Blues,26950,26950,0,movies-2017.csv,2017,1.0,0.0
5601,A Monster with a Thousand Heads,26865,24852,2013,movies-2016.csv,2016,0.925069793411502,0.07493020658849804
5602,"The Devil, Probably",26816,26816,0,movies-2012.csv,2012,1.0,0.0
5603,Tap World,26747,26747,0,movies-2015.csv,2015,1.0,0.0
5604,Peace Officer,26632,26632,0,movies-2015.csv,2015,1.0,0.0
5605,"Pink Ribbons, Inc.",26608,26608,0,movies-2012.csv,2012,1.0,0.0
5606,Wrestle,26597,26597,0,movies-2019.csv,2019,1.0,0.0
5607,Milford Graves Full Mantis,26566,26566,0,movies-2018.csv,2018,1.0,0.0
5608,José,26563,26563,0,movies-2020.csv,2020,1.0,0.0
5609,Front Cover,26409,26409,0,movies-2016.csv,2016,1.0,0.0
5610,At First Light,26338,3292,23046,movies-2018.csv,2018,0.12499050801123851,0.8750094919887614
5611,Marlina the Murderer in Four Acts,26331,17788,8543,movies-2018.csv,2018,0.6755535300596255,0.32444646994037446
5612,Donnybrook,26284,26284,0,movies-2019.csv,2019,1.0,0.0
5613,The Misandrists,26123,26123,0,movies-2018.csv,2018,1.0,0.0
5614,They Call us Monsters,26080,26080,0,movies-2017.csv,2017,1.0,0.0
5615,Ridge Runners,26019,26019,0,movies-2018.csv,2018,1.0,0.0
5616,Main Street,26011,2560,23451,movies-2011.csv,2011,0.09841989927338433,0.9015801007266157
5617,Jet Trash 2018 Re-release,26002,26002,0,movies-2018.csv,2018,1.0,0.0
5618,Black Mother,25919,18762,7157,movies-2018.csv,2018,0.7238705196959759,0.27612948030402407
5619,Django,25916,25916,0,movies-2012.csv,2012,1.0,0.0
5620,Women Like Us,25859,25859,0,movies-2017.csv,2017,1.0,0.0
5621,Caesar and Otto's Summer Camp Massacre,25844,25844,0,movies-2011.csv,2011,1.0,0.0
5622,Elena,25788,25788,0,movies-2014.csv,2014,1.0,0.0
5623,Gurukulam,25651,25651,0,movies-2016.csv,2016,1.0,0.0
5624,Passion Play,25603,3669,21934,movies-2011.csv,2011,0.14330351911885325,0.8566964808811467
5625,Banjo,25531,25531,0,movies-2016.csv,2016,1.0,0.0
5626,Waiting for Forever,25517,25517,0,movies-2011.csv,2011,1.0,0.0
5627,Unsubscribe,25488,25488,0,movies-2020.csv,2020,1.0,0.0
5628,Christian Mingle,25480,25480,0,movies-2014.csv,2014,1.0,0.0
5629,Kill Command,25427,0,25427,movies-2016.csv,2016,0.0,1.0
5630,Nobody Walks,25342,25342,0,movies-2012.csv,2012,1.0,0.0
5631,Rediscover Sautet,25314,25314,0,movies-2015.csv,2015,1.0,0.0
5632,Disturbing the Peace,25287,25287,0,movies-2016.csv,2016,1.0,0.0
5633,In Search of Fellini,25269,12772,12497,movies-2017.csv,2017,0.5054414499980213,0.49455855000197874
5634,Death of the Virgin,25247,25247,0,movies-2012.csv,2012,1.0,0.0
5635,The Worst Movie Ever!,25206,25206,0,movies-2011.csv,2011,1.0,0.0
5636,Vazante,25091,23884,1207,movies-2018.csv,2018,0.9518951018293412,0.0481048981706588
5637,Disappearance at Clifton Hill,25084,25084,0,movies-2020.csv,2020,1.0,0.0
5638,Bonnie & Clyde vs. Dracula,25027,25027,0,movies-2011.csv,2011,1.0,0.0
5639,The Lucky Man,25015,25015,0,movies-2017.csv,2017,1.0,0.0
5640,The Power of Few,25000,25000,0,movies-2013.csv,2013,1.0,0.0
5641,Ugetsu,24959,11197,13762,movies-2017.csv,2017,0.44861572979686687,0.5513842702031332
5642,R100,24956,24956,0,movies-2015.csv,2015,1.0,0.0
5643,Naples '44,24863,24620,243,movies-2017.csv,2017,0.9902264408961107,0.009773559103889313
5644,An Elephant's Journey,24844,24844,0,movies-2018.csv,2018,1.0,0.0
5645,Madaari,24822,0,24822,movies-2016.csv,2016,0.0,1.0
5646,Light from Light,24808,24808,0,movies-2019.csv,2019,1.0,0.0
5647,Marius/Fanny/César,24787,24787,0,movies-2017.csv,2017,1.0,0.0
5648,Paradise 2017 Re-release,24749,24749,0,movies-2017.csv,2017,1.0,0.0
5649,Strike,24743,15758,8985,movies-2019.csv,2019,0.6368669926847997,0.36313300731520026
5650,Stage Mother,24736,0,24736,movies-2020.csv,2020,0.0,1.0
5651,Cold Comes the Night,24732,16971,7761,movies-2013.csv,2013,0.6861960213488598,0.31380397865114024
5652,The Day,24686,20984,3702,movies-2012.csv,2012,0.8500364579113667,0.14996354208863324
5653,Hyenas,24672,24672,0,movies-2019.csv,2019,1.0,0.0
5654,The Departure,24662,24662,0,movies-2017.csv,2017,1.0,0.0
5655,Harvest,24657,24657,0,movies-2011.csv,2011,1.0,0.0
5656,Knuckle,24655,2647,22008,movies-2011.csv,2011,0.1073615899411884,0.8926384100588116
5657,Olvidados 2015 Re-release,24638,24638,0,movies-2015.csv,2015,1.0,0.0
5658,Born to Fly: Elizabeth Streb vs. Gravity,24630,24630,0,movies-2014.csv,2014,1.0,0.0
5659,The Aspern Papers,24554,9277,15277,movies-2019.csv,2019,0.3778203144090576,0.6221796855909424
5660,Immigration Tango,24554,24554,0,movies-2011.csv,2011,1.0,0.0
5661,After,24544,24544,0,movies-2011.csv,2011,1.0,0.0
5662,Graceland,24529,24529,0,movies-2013.csv,2013,1.0,0.0
5663,Too Late to Die Young,24487,16591,7896,movies-2018.csv,2018,0.6775431861804223,0.32245681381957775
5664,Sudden Fear,24476,24476,0,movies-2016.csv,2016,1.0,0.0
5665,Otter 501,24449,24449,0,movies-2012.csv,2012,1.0,0.0
5666,The Trial of the Chicago 7,24357,0,24357,movies-2020.csv,2020,0.0,1.0
5667,Last Days in the Desert,24352,0,24352,movies-2016.csv,2016,0.0,1.0
5668,Honeymoon,24343,9318,15025,movies-2014.csv,2014,0.3827794437826069,0.6172205562173931
5669,Le Petit Soldat,24296,24296,0,movies-2013.csv,2013,1.0,0.0
5670,Jasmine,24248,24248,0,movies-2017.csv,2017,1.0,0.0
5671,Heart of Africa,24139,24139,0,movies-2020.csv,2020,1.0,0.0
5672,Radio Unnameable,24090,24090,0,movies-2012.csv,2012,1.0,0.0
5673,Level Up,24083,1469,22614,movies-2016.csv,2016,0.06099738404683802,0.939002615953162
5674,Chasing Einstein,24057,24057,0,movies-2019.csv,2019,1.0,0.0
5675,Ranchero,24036,24036,0,movies-2011.csv,2011,1.0,0.0
5676,Steven Universe: The Movie,24012,0,24012,movies-2019.csv,2019,0.0,1.0
5677,Beneath the Darkness,23998,0,23998,movies-2012.csv,2012,0.0,1.0
5678,The Fiancé,23986,23986,0,movies-2016.csv,2016,1.0,0.0
5679,Harry Dean Stanton: Partly Fiction,23959,23959,0,movies-2013.csv,2013,1.0,0.0
5680,Almost Holy,23957,21142,2815,movies-2016.csv,2016,0.8824978085736945,0.11750219142630547
5681,Simple Creature,23918,23918,0,movies-2017.csv,2017,1.0,0.0
5682,Shut Up Little Man! An Audio Misadventure,23901,23901,0,movies-2011.csv,2011,1.0,0.0
5683,Dear Mr. Watterson,23899,23899,0,movies-2013.csv,2013,1.0,0.0
5684,Under The Wire,23897,3429,20468,movies-2018.csv,2018,0.14349081474662093,0.856509185253379
5685,Vincent N Roxxy,23896,0,23896,movies-2017.csv,2017,0.0,1.0
5686,Emoticon ;),23881,23881,0,movies-2014.csv,2014,1.0,0.0
5687,Happy Valley,23868,23868,0,movies-2014.csv,2014,1.0,0.0
5688,Argentina,23864,14869,8995,movies-2015.csv,2015,0.623072410325176,0.376927589674824
5689,Death House,23833,23833,0,movies-2018.csv,2018,1.0,0.0
5690,Greenwich Village: Music That Defined a Generation,23701,23701,0,movies-2013.csv,2013,1.0,0.0
5691,Raw Faith,23667,23667,0,movies-2011.csv,2011,1.0,0.0
5692,Southbound,23665,23665,0,movies-2016.csv,2016,1.0,0.0
5693,Good Kids,23627,0,23627,movies-2016.csv,2016,0.0,1.0
5694,"Phoenix, Oregon",23613,23613,0,movies-2020.csv,2020,1.0,0.0
5695,Lost Bohemia,23584,23584,0,movies-2011.csv,2011,1.0,0.0
5696,"A Woman, a Part",23562,23562,0,movies-2017.csv,2017,1.0,0.0
5697,An Evening with Beverly Luff Linn,23515,6701,16814,movies-2018.csv,2018,0.28496704231341696,0.715032957686583
5698,The Hill Chris Climbed: The Gridiron Heroes Story,23487,23487,0,movies-2016.csv,2016,1.0,0.0
5699,Letter from Masanjia,23481,23481,0,movies-2018.csv,2018,1.0,0.0
5700,Robert the Bruce,23425,0,23425,movies-2019.csv,2019,0.0,1.0
5701,Believe Me,23419,23419,0,movies-2014.csv,2014,1.0,0.0
5702,Can't Stand Losing You: Surviving the Police,23262,23262,0,movies-2015.csv,2015,1.0,0.0
5703,For Ahkeem,23136,23136,0,movies-2017.csv,2017,1.0,0.0
5704,The Judge,23127,22257,870,movies-2018.csv,2018,0.9623816318588663,0.03761836814113374
5705,Finding Oscar,23116,23116,0,movies-2017.csv,2017,1.0,0.0
5706,The Iran Job,23115,23115,0,movies-2012.csv,2012,1.0,0.0
5707,The Grace of Jake,23078,23078,0,movies-2017.csv,2017,1.0,0.0
5708,Premature,23071,23071,0,movies-2020.csv,2020,1.0,0.0
5709,Three Peaks,23069,16216,6853,movies-2018.csv,2018,0.7029346742381551,0.2970653257618449
5710,History of Jazz: Oxygen for the Ears,23048,23048,0,movies-2014.csv,2014,1.0,0.0
5711,Video Games: The Movie,23043,23043,0,movies-2014.csv,2014,1.0,0.0
5712,Goat,23020,23020,0,movies-2016.csv,2016,1.0,0.0
5713,Hellbound?,22887,22887,0,movies-2012.csv,2012,1.0,0.0
5714,Mirza's Lady,22886,0,22886,movies-2016.csv,2016,0.0,1.0
5715,Keyhole,22826,22826,0,movies-2012.csv,2012,1.0,0.0
5716,The Long Day Closes,22765,22765,0,movies-2012.csv,2012,1.0,0.0
5717,Carol Channing: Larger Than Life,22740,22740,0,movies-2012.csv,2012,1.0,0.0
5718,The Revisionaries,22664,22664,0,movies-2012.csv,2012,1.0,0.0
5719,Ode to Joy,22594,17303,5291,movies-2019.csv,2019,0.7658227848101266,0.23417721518987342
5720,Trophy,22553,21439,1114,movies-2017.csv,2017,0.9506052409878952,0.04939475901210482
5721,L'Innocente,22549,22549,0,movies-2020.csv,2020,1.0,0.0
5722,Anything,22537,19037,3500,movies-2018.csv,2018,0.8446998269512358,0.15530017304876426
5723,The Black Dove,22517,22517,0,movies-2016.csv,2016,1.0,0.0
5724,Casting By,22497,18164,4333,movies-2013.csv,2013,0.8073965417611237,0.19260345823887629
5725,Middleground,22490,0,22490,movies-2017.csv,2017,0.0,1.0
5726,Incendiary,22457,22457,0,movies-2011.csv,2011,1.0,0.0
5727,Realms,22443,147,22296,movies-2017.csv,2017,0.006549926480417056,0.9934500735195829
5728,Kamikaze 89,22440,22440,0,movies-2016.csv,2016,1.0,0.0
5729,Be Here Now,22424,22424,0,movies-2016.csv,2016,1.0,0.0
5730,Paradise Club,22381,22381,0,movies-2017.csv,2017,1.0,0.0
5731,Girl Model,22369,21154,1215,movies-2012.csv,2012,0.9456837587733024,0.05431624122669766
5732,The Painting,22313,21008,1305,movies-2012.csv,2012,0.9415139156545511,0.058486084345448844
5733,Tar,22307,22307,0,movies-2020.csv,2020,1.0,0.0
5734,The Atomic Cafe,22293,22293,0,movies-2018.csv,2018,1.0,0.0
5735,Metropolitan 2015 Re-release,22284,22284,0,movies-2015.csv,2015,1.0,0.0
5736,Slow Learners,22272,22272,0,movies-2015.csv,2015,1.0,0.0
5737,Generation Startup,22271,22271,0,movies-2016.csv,2016,1.0,0.0
5738,Reparation,22267,22267,0,movies-2016.csv,2016,1.0,0.0
5739,Winning Formula,22189,22189,0,movies-2018.csv,2018,1.0,0.0
5740,All's Faire in Love,22180,22180,0,movies-2011.csv,2011,1.0,0.0
5741,Princess Cut,22167,22167,0,movies-2015.csv,2015,1.0,0.0
5742,Murder Eleven,22107,22107,0,movies-2013.csv,2013,1.0,0.0
5743,Losing Control,22081,22081,0,movies-2012.csv,2012,1.0,0.0
5744,Four Adventures of Reinette and Mirabelle,22039,22039,0,movies-2011.csv,2011,1.0,0.0
5745,Answers to Nothing,22029,22029,0,movies-2011.csv,2011,1.0,0.0
5746,Pet,22003,8004,13999,movies-2016.csv,2016,0.3637685770122256,0.6362314229877744
5747,The Sound of Silence,21994,20013,1981,movies-2019.csv,2019,0.9099299809038829,0.09007001909611713
5748,The Passion of Joan of Arc,21877,21877,0,movies-2017.csv,2017,1.0,0.0
5749,Deep Gold 3D,21868,12000,9868,movies-2011.csv,2011,0.5487470276202671,0.45125297237973294
5750,The ABCs of Death,21832,21832,0,movies-2013.csv,2013,1.0,0.0
5751,Animals 2015 Re-release,21821,21821,0,movies-2015.csv,2015,1.0,0.0
5752,Viola,21818,21818,0,movies-2013.csv,2013,1.0,0.0
5753,The Female Brain,21786,21786,0,movies-2018.csv,2018,1.0,0.0
5754,Better Than Something: Jay Reatard,21697,21697,0,movies-2012.csv,2012,1.0,0.0
5755,Dead Awake,21675,11528,10147,movies-2017.csv,2017,0.5318569780853518,0.46814302191464824
5756,Évocateur: The Morton Downey Jr. Movie,21652,21652,0,movies-2013.csv,2013,1.0,0.0
5757,Sedona,21638,21638,0,movies-2012.csv,2012,1.0,0.0
5758,Blue Jay,21626,21626,0,movies-2016.csv,2016,1.0,0.0
5759,Wicked Witches,21600,21600,0,movies-2019.csv,2019,1.0,0.0
5760,Half the Picture,21589,21589,0,movies-2018.csv,2018,1.0,0.0
5761,Waiting for Lightning,21577,21577,0,movies-2012.csv,2012,1.0,0.0
5762,10 timer til Paradis,21561,16000,5561,movies-2012.csv,2012,0.742080608506099,0.25791939149390103
5763,Monogamy,21527,21527,0,movies-2011.csv,2011,1.0,0.0
5764,Thank You for Your Service,21497,21497,0,movies-2016.csv,2016,1.0,0.0
5765,Hagazussa,21487,13253,8234,movies-2018.csv,2018,0.616791548378089,0.3832084516219109
5766,Tyrel,21456,21456,0,movies-2018.csv,2018,1.0,0.0
5767,Song Of Granite,21349,16182,5167,movies-2017.csv,2017,0.7579746123940231,0.24202538760597686
5768,Tio Papi,21316,21316,0,movies-2013.csv,2013,1.0,0.0
5769,Memphis,21286,21286,0,movies-2014.csv,2014,1.0,0.0
5770,Resurrect Dead: The Mystery of the Toynbee Tiles,21242,21242,0,movies-2011.csv,2011,1.0,0.0
5771,Already Tomorrow in Hong Kong,21206,21206,0,movies-2016.csv,2016,1.0,0.0
5772,Ganja & Hess,21197,21197,0,movies-2018.csv,2018,1.0,0.0
5773,The Pale Door,21166,0,21166,movies-2020.csv,2020,0.0,1.0
5774,NightLights,21147,21147,0,movies-2014.csv,2014,1.0,0.0
5775,God Knows Where I Am,21135,21135,0,movies-2017.csv,2017,1.0,0.0
5776,The Happys,21108,21108,0,movies-2018.csv,2018,1.0,0.0
5777,Massacre on Aisle 12,21106,21106,0,movies-2017.csv,2017,1.0,0.0
5778,A Beginner's Guide to Snuff,21031,21031,0,movies-2017.csv,2017,1.0,0.0
5779,The Sacrifice 2014 Re-release,20945,20945,0,movies-2014.csv,2014,1.0,0.0
5780,Round of Your Life,20941,20941,0,movies-2019.csv,2019,1.0,0.0
5781,Ava,20940,20940,0,movies-2018.csv,2018,1.0,0.0
5782,Man Underground,20907,20907,0,movies-2017.csv,2017,1.0,0.0
5783,Lekar Hum Deewana Dil,20874,20874,0,movies-2014.csv,2014,1.0,0.0
5784,Cameraman: The Life and Work of Jack Cardiff,20840,20840,0,movies-2011.csv,2011,1.0,0.0
5785,Time Changer 2016 Re-release,20797,20797,0,movies-2016.csv,2016,1.0,0.0
5786,Did You Wonder Who Fired the Gun?,20765,20765,0,movies-2018.csv,2018,1.0,0.0
5787,All These Sleepless Nights,20762,20762,0,movies-2017.csv,2017,1.0,0.0
5788,For Ellen,20746,12396,8350,movies-2012.csv,2012,0.5975127735467078,0.4024872264532922
5789,The Ghosts in Our Machine,20709,20709,0,movies-2013.csv,2013,1.0,0.0
5790,The Great Flood,20694,20694,0,movies-2014.csv,2014,1.0,0.0
5791,Freak Show,20657,19696,961,movies-2018.csv,2018,0.9534782398218522,0.046521760178147846
5792,Our Nixon,20584,20584,0,movies-2013.csv,2013,1.0,0.0
5793,Fidelio: Alice's Odyssey,20571,3580,16991,movies-2015.csv,2015,0.17403140343201595,0.825968596567984
5794,Coming Up Roses 2014 Re-release,20567,20567,0,movies-2014.csv,2014,1.0,0.0
5795,Band of Robbers,20555,20555,0,movies-2016.csv,2016,1.0,0.0
5796,The Work,20554,5853,14701,movies-2017.csv,2017,0.28476209010411596,0.715237909895884
5797,Ice Dragon: Legend of the Blue Daisies,20549,20549,0,movies-2018.csv,2018,1.0,0.0
5798,This Last Lonely Place,20507,20507,0,movies-2016.csv,2016,1.0,0.0
5799,Consumed,20476,20476,0,movies-2015.csv,2015,1.0,0.0
5800,The Devil and Father Amorth,20449,20449,0,movies-2018.csv,2018,1.0,0.0
5801,Boy Meets Girl,20441,20441,0,movies-2015.csv,2015,1.0,0.0
5802,Burden,20437,18440,1997,movies-2017.csv,2017,0.9022850711944023,0.09771492880559769
5803,Never,20431,20431,0,movies-2016.csv,2016,1.0,0.0
5804,The Highest Pass,20386,20386,0,movies-2012.csv,2012,1.0,0.0
5805,The All Americans,20324,20324,0,movies-2019.csv,2019,1.0,0.0
5806,Koroshiya 1 2017 Re-release,20285,20285,0,movies-2017.csv,2017,1.0,0.0
5807,Izzy Gets the F*ck Across Town,20208,20208,0,movies-2018.csv,2018,1.0,0.0
5808,New World Order,20205,20205,0,movies-2016.csv,2016,1.0,0.0
5809,Jesus Henry Christ,20183,20183,0,movies-2012.csv,2012,1.0,0.0
5810,Friends and Romans,20136,20136,0,movies-2015.csv,2015,1.0,0.0
5811,How to Grow a Band,20135,20135,0,movies-2012.csv,2012,1.0,0.0
5812,The Man from Outer Space,20102,20102,0,movies-2017.csv,2017,1.0,0.0
5813,Love Me True,20100,20100,0,movies-2016.csv,2016,1.0,0.0
5814,The Past is a Grotesque Animal,20056,20056,0,movies-2014.csv,2014,1.0,0.0
5815,Apocalypsis,20052,20052,0,movies-2018.csv,2018,1.0,0.0
5816,General Magic,20046,20046,0,movies-2019.csv,2019,1.0,0.0
5817,The Gospel of Eureka,20039,20039,0,movies-2019.csv,2019,1.0,0.0
5818,"No Pay, Nudity",20017,20017,0,movies-2016.csv,2016,1.0,0.0
5819,Lore,20006,20006,0,movies-2020.csv,2020,1.0,0.0
5820,Eight Hours Don't Make a Day,19987,19987,0,movies-2018.csv,2018,1.0,0.0
5821,"One Sings, the Other Doesn't",19919,19919,0,movies-2018.csv,2018,1.0,0.0
5822,Wedding Palace,19908,19908,0,movies-2013.csv,2013,1.0,0.0
5823,Forbidden Games,19889,19889,0,movies-2015.csv,2015,1.0,0.0
5824,Foster Boy,19873,19873,0,movies-2020.csv,2020,1.0,0.0
5825,Active Measures,19862,19862,0,movies-2018.csv,2018,1.0,0.0
5826,Heat and Dust 2017 Re-release,19856,19856,0,movies-2017.csv,2017,1.0,0.0
5827,Wild Canaries,19777,19777,0,movies-2015.csv,2015,1.0,0.0
5828,The Romans,19705,19705,0,movies-2016.csv,2016,1.0,0.0
5829,Trafficked,19698,19698,0,movies-2017.csv,2017,1.0,0.0
5830,Misery Loves Comedy,19634,19634,0,movies-2015.csv,2015,1.0,0.0
5831,Bad Milo,19613,19613,0,movies-2013.csv,2013,1.0,0.0
5832,Art Bastard,19600,19600,0,movies-2016.csv,2016,1.0,0.0
5833,Uzumasa Limelight,19597,19597,0,movies-2014.csv,2014,1.0,0.0
5834,Zoology,19572,0,19572,movies-2016.csv,2016,0.0,1.0
5835,Damascus Cover,19532,0,19532,movies-2018.csv,2018,0.0,1.0
5836,Comet,19530,8623,10907,movies-2014.csv,2014,0.4415258576548899,0.5584741423451101
5837,Hannah: Buddhism's Untold Journey,19526,396,19130,movies-2016.csv,2016,0.02028065143910683,0.9797193485608932
5838,BOSTON: An American Running Story 2017 Re-release,19499,19499,0,movies-2017.csv,2017,1.0,0.0
5839,Grassroots,19492,12356,7136,movies-2012.csv,2012,0.6339010876256926,0.3660989123743074
5840,In Over My Head,19482,19482,0,movies-2012.csv,2012,1.0,0.0
5841,A Picture of You,19480,19480,0,movies-2014.csv,2014,1.0,0.0
5842,Guardian Angel,19480,19480,0,movies-2014.csv,2014,1.0,0.0
5843,Whensday,19463,19463,0,movies-2013.csv,2013,1.0,0.0
5844,Hunter Gatherer,19462,19462,0,movies-2016.csv,2016,1.0,0.0
5845,Skateland,19411,19411,0,movies-2011.csv,2011,1.0,0.0
5846,She Is the Ocean,19394,18828,566,movies-2020.csv,2020,0.9708157162008869,0.029184283799113128
5847,Mansfield 66/67,19390,17930,1460,movies-2017.csv,2017,0.9247034553893759,0.07529654461062403
5848,Tchoupitoulas,19375,19375,0,movies-2012.csv,2012,1.0,0.0
5849,Actress,19365,19365,0,movies-2014.csv,2014,1.0,0.0
5850,Peter Brook: The Tightrope,19365,19365,0,movies-2014.csv,2014,1.0,0.0
5851,Watchers of the Sky,19339,19339,0,movies-2014.csv,2014,1.0,0.0
5852,Gabo: The Creation of Gabriel Garcia Marquez,19337,19337,0,movies-2015.csv,2015,1.0,0.0
5853,Jackie & Ryan,19305,0,19305,movies-2015.csv,2015,0.0,1.0
5854,Reuniting the Rubins,19288,13569,5719,movies-2011.csv,2011,0.703494400663625,0.29650559933637494
5855,Romeos,19248,1081,18167,movies-2011.csv,2011,0.056161679135494594,0.9438383208645054
5856,Mandy 2020 Re-release,19169,19169,0,movies-2020.csv,2020,1.0,0.0
5857,Who We Are Now,19128,19128,0,movies-2018.csv,2018,1.0,0.0
5858,That Most Important Thing: Love,19120,19120,0,movies-2017.csv,2017,1.0,0.0
5859,Revelation: Dawn of Global Government,19107,19107,0,movies-2016.csv,2016,1.0,0.0
5860,Make Believe,19085,19085,0,movies-2011.csv,2011,1.0,0.0
5861,November,19084,19084,0,movies-2018.csv,2018,1.0,0.0
5862,Search Engines,19033,19033,0,movies-2016.csv,2016,1.0,0.0
5863,The Challenger,19003,19003,0,movies-2015.csv,2015,1.0,0.0
5864,The Color Wheel,19001,19001,0,movies-2012.csv,2012,1.0,0.0
5865,The Kill Team,18983,18983,0,movies-2014.csv,2014,1.0,0.0
5866,Sophomore,18945,18945,0,movies-2012.csv,2012,1.0,0.0
5867,Smash & Grab: The Story of the Pink Panthers,18938,18938,0,movies-2013.csv,2013,1.0,0.0
5868,Ktown Cowboys,18863,18863,0,movies-2016.csv,2016,1.0,0.0
5869,Nostalgia,18846,18846,0,movies-2013.csv,2013,1.0,0.0
5870,Frank and Ava,18829,18829,0,movies-2018.csv,2018,1.0,0.0
5871,Test,18823,18823,0,movies-2014.csv,2014,1.0,0.0
5872,The Sorcerer and the White Snake 2013 Re-release,18759,18759,0,movies-2013.csv,2013,1.0,0.0
5873,Scandalous: The True Story of the National Enquirer,18759,18759,0,movies-2019.csv,2019,1.0,0.0
5874,Before Stonewall,18724,18724,0,movies-2019.csv,2019,1.0,0.0
5875,Seoul Searching,18654,18654,0,movies-2016.csv,2016,1.0,0.0
5876,Crime + Punishment,18644,18644,0,movies-2018.csv,2018,1.0,0.0
5877,A Single Shot,18642,18642,0,movies-2013.csv,2013,1.0,0.0
5878,Wish Me Away,18618,18618,0,movies-2012.csv,2012,1.0,0.0
5879,The Return of Martin Guerre 2019 Re-release,18603,18603,0,movies-2019.csv,2019,1.0,0.0
5880,The Pagan King: The Battle of Death,18598,0,18598,movies-2018.csv,2018,0.0,1.0
5881,Bobbi Jene,18579,18579,0,movies-2017.csv,2017,1.0,0.0
5882,La Camioneta: The Journey of One American School Bus,18558,18558,0,movies-2013.csv,2013,1.0,0.0
5883,Let My People Go!,18529,18529,0,movies-2013.csv,2013,1.0,0.0
5884,Allegiance to Broadway,18527,18527,0,movies-2018.csv,2018,1.0,0.0
5885,Desolation,18490,18490,0,movies-2018.csv,2018,1.0,0.0
5886,All the Rage,18489,18489,0,movies-2017.csv,2017,1.0,0.0
5887,The Ghoul,18459,2032,16427,movies-2017.csv,2017,0.11008180291456741,0.8899181970854326
5888,306 Hollywood,18399,18399,0,movies-2018.csv,2018,1.0,0.0
5889,Shithouse,18370,18370,0,movies-2020.csv,2020,1.0,0.0
5890,Oka!,18364,18364,0,movies-2011.csv,2011,1.0,0.0
5891,"Phoenix, Oregon",18356,18356,0,movies-2019.csv,2019,1.0,0.0
5892,"Intent to Destroy: Death, Denial & Depiction 2017 Re-release",18340,18340,0,movies-2017.csv,2017,1.0,0.0
5893,The Channel,18319,18319,0,movies-2016.csv,2016,1.0,0.0
5894,Four Bags Full,18297,18297,0,movies-2013.csv,2013,1.0,0.0
5895,SHOT! The Psycho-Spiritual Mantra of Rock,18295,15157,3138,movies-2017.csv,2017,0.8284777261546871,0.17152227384531293
5896,Tosca's Kiss,18236,18236,0,movies-2014.csv,2014,1.0,0.0
5897,Torn,18202,18202,0,movies-2013.csv,2013,1.0,0.0
5898,Marcelino Pan y Vino 2012 Re-release,18193,18193,0,movies-2012.csv,2012,1.0,0.0
5899,Who is Dayani Cristal?,18190,18190,0,movies-2014.csv,2014,1.0,0.0
5900,The Lion in Winter 2016 Re-release,18177,18177,0,movies-2016.csv,2016,1.0,0.0
5901,Coming Through the Rye,18137,18137,0,movies-2016.csv,2016,1.0,0.0
5902,King of Hearts,18130,17646,484,movies-2018.csv,2018,0.973303916161059,0.02669608383894098
5903,Peter and the Farm,18123,18123,0,movies-2016.csv,2016,1.0,0.0
5904,Harry Benson: Shoot First,18092,18092,0,movies-2016.csv,2016,1.0,0.0
5905,A Bit of Bad Luck,18089,18089,0,movies-2016.csv,2016,1.0,0.0
5906,Total Recall 2012 Re-release,18081,18081,0,movies-2012.csv,2012,1.0,0.0
5907,Holy Hell,18051,18051,0,movies-2016.csv,2016,1.0,0.0
5908,On Tour with Pina Bausch,18016,18016,0,movies-2014.csv,2014,1.0,0.0
5909,I Knew Her Well,18010,18010,0,movies-2016.csv,2016,1.0,0.0
5910,Men Go to Battle,18006,18006,0,movies-2016.csv,2016,1.0,0.0
5911,Battle for Brooklyn,18000,18000,0,movies-2011.csv,2011,1.0,0.0
5912,Jamel Shabazz Street Photographer,17992,17992,0,movies-2013.csv,2013,1.0,0.0
5913,Payback,17979,17979,0,movies-2012.csv,2012,1.0,0.0
5914,Cook County,17977,17977,0,movies-2011.csv,2011,1.0,0.0
5915,The Cranes Are Flying,17923,17923,0,movies-2019.csv,2019,1.0,0.0
5916,Dealin' with Idiots,17909,17909,0,movies-2013.csv,2013,1.0,0.0
5917,Li'l Quinquin,17868,7192,10676,movies-2015.csv,2015,0.4025072755764495,0.5974927244235505
5918,The Last Shaman,17844,17844,0,movies-2017.csv,2017,1.0,0.0
5919,Made in Hong Kong,17843,17843,0,movies-2020.csv,2020,1.0,0.0
5920,David,17828,0,17828,movies-2013.csv,2013,0.0,1.0
5921,Batman: Mask of the Phantasm 2018 Re-release,17813,17813,0,movies-2018.csv,2018,1.0,0.0
5922,Escapes,17778,17778,0,movies-2017.csv,2017,1.0,0.0
5923,Sacred,17740,17740,0,movies-2017.csv,2017,1.0,0.0
5924,Little Birds,17739,17739,0,movies-2012.csv,2012,1.0,0.0
5925,The Other One,17727,17727,0,movies-2015.csv,2015,1.0,0.0
5926,Kelly & Cal,17702,17702,0,movies-2014.csv,2014,1.0,0.0
5927,Bad Grandmas,17688,17688,0,movies-2017.csv,2017,1.0,0.0
5928,The History of Future Folk,17646,17646,0,movies-2013.csv,2013,1.0,0.0
5929,Kills On Wheels 2016 Re-release,17595,15898,1697,movies-2017.csv,2017,0.9035521454958795,0.0964478545041205
5930,How He Fell in Love,17575,17575,0,movies-2016.csv,2016,1.0,0.0
5931,The Chronicle of Anna Magdalena Bach,17527,17527,0,movies-2018.csv,2018,1.0,0.0
5932,Streit's: Matzo and the American Dream,17506,17506,0,movies-2016.csv,2016,1.0,0.0
5933,Butterfly Girl,17503,17503,0,movies-2015.csv,2015,1.0,0.0
5934,Chained for Life,17431,17431,0,movies-2019.csv,2019,1.0,0.0
5935,Pandora and the Flying Dutchman 2020 Re-release,17401,17401,0,movies-2020.csv,2020,1.0,0.0
5936,"A Bread Factory, Part One/A Bread Factory, Part Two",17325,17325,0,movies-2018.csv,2018,1.0,0.0
5937,Littlerock,17309,17309,0,movies-2011.csv,2011,1.0,0.0
5938,The Homestretch,17306,17306,0,movies-2014.csv,2014,1.0,0.0
5939,Archie's Final Project,17282,17282,0,movies-2011.csv,2011,1.0,0.0
5940,Stand Clear of the Closing Doors,17282,17282,0,movies-2014.csv,2014,1.0,0.0
5941,Revival,17252,17252,0,movies-2018.csv,2018,1.0,0.0
5942,Landfill Harmonic,17205,17205,0,movies-2016.csv,2016,1.0,0.0
5943,Food Evolution,17181,17181,0,movies-2017.csv,2017,1.0,0.0
5944,Accident 2014 Re-release,17161,17161,0,movies-2014.csv,2014,1.0,0.0
5945,Le Pont du Nord,17110,17110,0,movies-2013.csv,2013,1.0,0.0
5946,Always Shine,17102,17102,0,movies-2016.csv,2016,1.0,0.0
5947,On the Map,17099,17099,0,movies-2016.csv,2016,1.0,0.0
5948,Grandmaster,17077,17077,0,movies-2012.csv,2012,1.0,0.0
5949,The Understudy,17036,17036,0,movies-2012.csv,2012,1.0,0.0
5950,Goodbye to All That,16986,16986,0,movies-2014.csv,2014,1.0,0.0
5951,The Prophet's Son,16983,16983,0,movies-2012.csv,2012,1.0,0.0
5952,Joseph Pulitzer: Voice of the People,16970,16970,0,movies-2019.csv,2019,1.0,0.0
5953,Advocate,16942,16942,0,movies-2020.csv,2020,1.0,0.0
5954,Return,16886,16124,762,movies-2012.csv,2012,0.9548738600023688,0.045126139997631175
5955,Hank and Asha,16878,16878,0,movies-2014.csv,2014,1.0,0.0
5956,Swim Team,16783,16783,0,movies-2017.csv,2017,1.0,0.0
5957,Night Across the Street,16778,16778,0,movies-2013.csv,2013,1.0,0.0
5958,Eva 2015 Re-release,16738,16738,0,movies-2015.csv,2015,1.0,0.0
5959,Inventing Our Life: The Kibbutz Experiment,16734,16734,0,movies-2012.csv,2012,1.0,0.0
5960,This Changes Everything,16692,16692,0,movies-2015.csv,2015,1.0,0.0
5961,The World of Kanako 2015 Re-release,16627,16627,0,movies-2015.csv,2015,1.0,0.0
5962,The Freedom to Marry,16611,16611,0,movies-2017.csv,2017,1.0,0.0
5963,Who Took Johnny,16595,16595,0,movies-2015.csv,2015,1.0,0.0
5964,Haikara-San: Here Comes Miss Modern,16572,16572,0,movies-2018.csv,2018,1.0,0.0
5965,Life in a Walk,16557,16557,0,movies-2015.csv,2015,1.0,0.0
5966,Brave New Jersey,16544,16544,0,movies-2017.csv,2017,1.0,0.0
5967,33 & Beyond: The Royal Art of Freemasonry,16533,16533,0,movies-2017.csv,2017,1.0,0.0
5968,Mission Control: The Unsung Heroes of Apollo,16405,16405,0,movies-2017.csv,2017,1.0,0.0
5969,Magician: The Astonishing Life and Work of Orson Welles,16400,16400,0,movies-2014.csv,2014,1.0,0.0
5970,Dying to Know: Ram Dass & Timothy Leary,16397,16397,0,movies-2017.csv,2017,1.0,0.0
5971,Design Is One: The Vignellis,16386,16386,0,movies-2013.csv,2013,1.0,0.0
5972,Centigrade,16263,16263,0,movies-2020.csv,2020,1.0,0.0
5973,I Melt with You,16232,6361,9871,movies-2011.csv,2011,0.3918802365697388,0.6081197634302612
5974,The Human Centipede III (Final Sequence),16184,16184,0,movies-2015.csv,2015,1.0,0.0
5975,This is Our Land,16182,11567,4615,movies-2017.csv,2017,0.7148065752070202,0.2851934247929799
5976,Detour,16172,16172,0,movies-2018.csv,2018,1.0,0.0
5977,All the Queen's Horses,16172,16172,0,movies-2017.csv,2017,1.0,0.0
5978,Virginia Minnesota,16118,16118,0,movies-2019.csv,2019,1.0,0.0
5979,Levitated Mass,16086,16086,0,movies-2014.csv,2014,1.0,0.0
5980,Straight Up,16080,16080,0,movies-2020.csv,2020,1.0,0.0
5981,1920 London,16077,0,16077,movies-2016.csv,2016,0.0,1.0
5982,Out of the Clear Blue Sky,16050,16050,0,movies-2013.csv,2013,1.0,0.0
5983,Long Shot: The Kevin Laue Story,16011,16011,0,movies-2012.csv,2012,1.0,0.0
5984,Planet of Snail,16002,13957,2045,movies-2012.csv,2012,0.8722034745656793,0.1277965254343207
5985,Supercapitalist,16000,16000,0,movies-2012.csv,2012,1.0,0.0
5986,Charged: The Eduardo Garcia Story,15920,15920,0,movies-2017.csv,2017,1.0,0.0
5987,Can You Dig This,15909,15909,0,movies-2015.csv,2015,1.0,0.0
5988,The Bay of Silence,15889,1941,13948,movies-2020.csv,2020,0.12215998489521052,0.8778400151047895
5989,This Binary Universe,15875,15875,0,movies-2012.csv,2012,1.0,0.0
5990,Starfish,15849,15849,0,movies-2019.csv,2019,1.0,0.0
5991,A Reason,15792,15792,0,movies-2015.csv,2015,1.0,0.0
5992,Defining Hope,15788,15788,0,movies-2017.csv,2017,1.0,0.0
5993,Take Me Home,15760,15760,0,movies-2012.csv,2012,1.0,0.0
5994,Full Moon in Paris,15726,15726,0,movies-2015.csv,2015,1.0,0.0
5995,Trinity Seven The Movie 2: Heavens Library & Crimson Lord,15712,15712,0,movies-2019.csv,2019,1.0,0.0
5996,Dreams Rewired,15626,11843,3783,movies-2015.csv,2015,0.7579034941763727,0.2420965058236273
5997,Out on Stage,15623,15623,0,movies-2018.csv,2018,1.0,0.0
5998,The Competition 2019 Re-release,15622,15622,0,movies-2019.csv,2019,1.0,0.0
5999,Basmati Blues,15605,0,15605,movies-2017.csv,2017,0.0,1.0
6000,Five Nights in Maine,15587,15587,0,movies-2016.csv,2016,1.0,0.0
6001,Bob le Flambeur,15586,15586,0,movies-2018.csv,2018,1.0,0.0
6002,When You Read This Letter,15552,15552,0,movies-2018.csv,2018,1.0,0.0
6003,Postcards from London,15548,5312,10236,movies-2018.csv,2018,0.3416516593774119,0.6583483406225881
6004,Stuffed,15532,15532,0,movies-2019.csv,2019,1.0,0.0
6005,Counter Column,15529,15529,0,movies-2020.csv,2020,1.0,0.0
6006,Tom of Finland 2018 Re-release,15483,3314,12169,movies-2018.csv,2018,0.21404120648453143,0.7859587935154686
6007,They Will Have to Kill Us First: Malian Music In Exile,15453,7516,7937,movies-2015.csv,2015,0.48637804956966285,0.5136219504303372
6008,California Solo,15433,15433,0,movies-2012.csv,2012,1.0,0.0
6009,Be Somebody,15395,15395,0,movies-2016.csv,2016,1.0,0.0
6010,Between the Lines,15383,15383,0,movies-2019.csv,2019,1.0,0.0
6011,Dumbstruck,15379,15379,0,movies-2011.csv,2011,1.0,0.0
6012,The Adderall Diaries,15364,13191,2173,movies-2016.csv,2016,0.8585654777401718,0.14143452225982817
6013,The President,15338,7578,7760,movies-2016.csv,2016,0.4940670230799322,0.5059329769200678
6014,Narcissister Organ Player,15334,15334,0,movies-2018.csv,2018,1.0,0.0
6015,Only the Young,15312,15312,0,movies-2012.csv,2012,1.0,0.0
6016,Contemporary Color,15305,15305,0,movies-2017.csv,2017,1.0,0.0
6017,American Deep State,15269,15269,0,movies-2020.csv,2020,1.0,0.0
6018,Starcrossed,15263,15263,0,movies-2016.csv,2016,1.0,0.0
6019,Arabian Nights: Volume 2 - The Desolate One,15245,6398,8847,movies-2015.csv,2015,0.4196785831420138,0.5803214168579862
6020,People's Republic of Desire,15241,15241,0,movies-2018.csv,2018,1.0,0.0
6021,The Samaritan,15220,2521,12699,movies-2012.csv,2012,0.16563731931668857,0.8343626806833114
6022,Funan,15152,15152,0,movies-2019.csv,2019,1.0,0.0
6023,The Olivia Experiment,15122,15122,0,movies-2014.csv,2014,1.0,0.0
6024,Kung Fu Joe,15120,15120,0,movies-2012.csv,2012,1.0,0.0
6025,Trade of Innocents,15091,15091,0,movies-2012.csv,2012,1.0,0.0
6026,Rebels on Pointe,15088,15088,0,movies-2017.csv,2017,1.0,0.0
6027,Cheatin',15077,15077,0,movies-2015.csv,2015,1.0,0.0
6028,Barefoot,15071,15071,0,movies-2014.csv,2014,1.0,0.0
6029,Caught in the Web,15033,1067,13966,movies-2012.csv,2012,0.07097718352956828,0.9290228164704317
6030,I'm Not Jesus Mommy,15005,15005,0,movies-2011.csv,2011,1.0,0.0
6031,The Tenant,15003,15003,0,movies-2011.csv,2011,1.0,0.0
6032,Wrinkles the Clown,14938,14938,0,movies-2019.csv,2019,1.0,0.0
6033,I Declare War,14928,14928,0,movies-2013.csv,2013,1.0,0.0
6034,Trust Machine: The Story of Blockchain,14905,14905,0,movies-2018.csv,2018,1.0,0.0
6035,La Maison de la radio,14905,8095,6810,movies-2013.csv,2013,0.5431063401543106,0.45689365984568936
6036,ZZ Top: That Little Ol' Band from Texas,14879,14879,0,movies-2019.csv,2019,1.0,0.0
6037,Horses of God 2014 Re-release,14817,14817,0,movies-2014.csv,2014,1.0,0.0
6038,Vince Giordano: There's a Future in the Past,14807,14807,0,movies-2017.csv,2017,1.0,0.0
6039,Kiss of the Damned,14752,14752,0,movies-2013.csv,2013,1.0,0.0
6040,The Prey 2012 Re-release,14738,13959,779,movies-2012.csv,2012,0.9471434387298141,0.05285656127018591
6041,Sweet Virginia,14725,11753,2972,movies-2017.csv,2017,0.7981663837011884,0.20183361629881155
6042,Gloria,14701,14701,0,movies-2015.csv,2015,1.0,0.0
6043,30 Beats,14693,14693,0,movies-2012.csv,2012,1.0,0.0
6044,Last Men in Aleppo,14637,14637,0,movies-2017.csv,2017,1.0,0.0
6045,10 Days in a Madhouse,14616,14616,0,movies-2015.csv,2015,1.0,0.0
6046,Unraveled,14615,14615,0,movies-2012.csv,2012,1.0,0.0
6047,Buzzard,14591,14591,0,movies-2015.csv,2015,1.0,0.0
6048,Tristana,14586,14586,0,movies-2012.csv,2012,1.0,0.0
6049,Ferrante Fever,14518,11137,3381,movies-2018.csv,2018,0.7671166827386693,0.23288331726133077
6050,The Wanderers 2016 Re-release,14492,14492,0,movies-2016.csv,2016,1.0,0.0
6051,Antarctica: Ice and Sky 2017 Re-release,14475,14475,0,movies-2017.csv,2017,1.0,0.0
6052,The Public Image is Rotten,14464,11293,3171,movies-2018.csv,2018,0.7807660398230089,0.21923396017699115
6053,My Son 2019 Re-release,14450,14450,0,movies-2019.csv,2019,1.0,0.0
6054,The Last Movie Star,14410,14410,0,movies-2018.csv,2018,1.0,0.0
6055,The Unbelievers,14400,14400,0,movies-2013.csv,2013,1.0,0.0
6056,The Uncondemned,14393,14393,0,movies-2016.csv,2016,1.0,0.0
6057,Exhibition,14378,14344,34,movies-2014.csv,2014,0.9976352761162888,0.0023647238837112253
6058,Justice Is Mind,14360,14360,0,movies-2013.csv,2013,1.0,0.0
6059,Gone Doggy Gone,14354,14354,0,movies-2015.csv,2015,1.0,0.0
6060,Peep World,14351,14351,0,movies-2011.csv,2011,1.0,0.0
6061,Machines,14331,9710,4621,movies-2017.csv,2017,0.6775521596538971,0.32244784034610285
6062,Never Stand Still,14272,14272,0,movies-2012.csv,2012,1.0,0.0
6063,Combat Obscura,14242,14242,0,movies-2019.csv,2019,1.0,0.0
6064,Saheb Biwi Aur Gangster,14231,14231,0,movies-2011.csv,2011,1.0,0.0
6065,Brother Nature,14218,14218,0,movies-2016.csv,2016,1.0,0.0
6066,A Perfect Man,14147,7117,7030,movies-2013.csv,2013,0.5030748568601117,0.49692514313988834
6067,Newtown,14109,14109,0,movies-2016.csv,2016,1.0,0.0
6068,We Won't Grow Old Together,14104,14104,0,movies-2012.csv,2012,1.0,0.0
6069,"I Was at Home, But...",14078,14078,0,movies-2020.csv,2020,1.0,0.0
6070,Shangri-La Suite,14073,14073,0,movies-2016.csv,2016,1.0,0.0
6071,Gayby,14062,14062,0,movies-2012.csv,2012,1.0,0.0
6072,6 Month Rule,14057,14057,0,movies-2012.csv,2012,1.0,0.0
6073,Head Games,14056,14056,0,movies-2012.csv,2012,1.0,0.0
6074,Chasing the Blues,14030,14030,0,movies-2018.csv,2018,1.0,0.0
6075,Il Futuro,14001,14001,0,movies-2013.csv,2013,1.0,0.0
6076,Screwball,13967,13967,0,movies-2019.csv,2019,1.0,0.0
6077,Yosemite,13931,13931,0,movies-2016.csv,2016,1.0,0.0
6078,Weed the People,13926,13926,0,movies-2018.csv,2018,1.0,0.0
6079,This Is Martin Bonner,13888,13888,0,movies-2013.csv,2013,1.0,0.0
6080,Falling Away,13869,13869,0,movies-2012.csv,2012,1.0,0.0
6081,Genesis,13856,6784,7072,movies-2019.csv,2019,0.4896073903002309,0.5103926096997691
6082,Backcountry,13848,13848,0,movies-2015.csv,2015,1.0,0.0
6083,Sympathy for Delicious,13826,13826,0,movies-2011.csv,2011,1.0,0.0
6084,Stavisky...,13793,13793,0,movies-2018.csv,2018,1.0,0.0
6085,The Pretty One,13769,13769,0,movies-2014.csv,2014,1.0,0.0
6086,A Space Program,13739,13739,0,movies-2016.csv,2016,1.0,0.0
6087,Dorfman in Love,13737,13737,0,movies-2013.csv,2013,1.0,0.0
6088,Time to Die,13707,13707,0,movies-2017.csv,2017,1.0,0.0
6089,Daisies,13692,13692,0,movies-2012.csv,2012,1.0,0.0
6090,This One's for the Ladies,13688,13688,0,movies-2019.csv,2019,1.0,0.0
6091,The Law in These Parts,13683,13683,0,movies-2012.csv,2012,1.0,0.0
6092,Tikkun,13671,13671,0,movies-2016.csv,2016,1.0,0.0
6093,Red Trees,13666,13666,0,movies-2017.csv,2017,1.0,0.0
6094,Fifi Howls from Happiness,13614,13614,0,movies-2014.csv,2014,1.0,0.0
6095,When the Iron Bird Flies: Tibetan Buddhism Arrives in the West,13598,13598,0,movies-2012.csv,2012,1.0,0.0
6096,Stray Dogs,13573,10433,3140,movies-2014.csv,2014,0.7686583658734252,0.23134163412657482
6097,Eli,13547,13547,0,movies-2015.csv,2015,1.0,0.0
6098,Dysfunctional Friends,13546,13546,0,movies-2012.csv,2012,1.0,0.0
6099,Shadowman,13498,13498,0,movies-2017.csv,2017,1.0,0.0
6100,Spices of Liberty,13463,13463,0,movies-2016.csv,2016,1.0,0.0
6101,War of the Worlds: Goliath,13385,13385,0,movies-2014.csv,2014,1.0,0.0
6102,Solaris 2017 Re-release,13352,0,13352,movies-2017.csv,2017,0.0,1.0
6103,Rapid Response,13294,13294,0,movies-2019.csv,2019,1.0,0.0
6104,Late Spring,13254,13254,0,movies-2016.csv,2016,1.0,0.0
6105,Days and Nights,13243,13243,0,movies-2014.csv,2014,1.0,0.0
6106,Our Blood is Wine,13210,13210,0,movies-2018.csv,2018,1.0,0.0
6107,"Intent to Destroy: Death, Denial & Depiction",13194,13194,0,movies-2017.csv,2017,1.0,0.0
6108,Sol LeWitt,13146,13146,0,movies-2014.csv,2014,1.0,0.0
6109,The Pleasures of Being Out of Step,13137,13137,0,movies-2014.csv,2014,1.0,0.0
6110,The Trouble with Bliss,13093,13093,0,movies-2012.csv,2012,1.0,0.0
6111,Under the Boardwalk: The Monopoly Story,13080,13080,0,movies-2011.csv,2011,1.0,0.0
6112,Nothing But a Man,13063,13063,0,movies-2012.csv,2012,1.0,0.0
6113,"How Much Does Your Building Weigh, Mr Foster? 2012 Re-release",13013,13013,0,movies-2012.csv,2012,1.0,0.0
6114,Bloodworth,12971,12971,0,movies-2011.csv,2011,1.0,0.0
6115,Like Me,12965,12965,0,movies-2018.csv,2018,1.0,0.0
6116,Duet for Cannibals 2019 re-release,12962,12962,0,movies-2019.csv,2019,1.0,0.0
6117,K2: Siren of the Himalayas,12959,12959,0,movies-2014.csv,2014,1.0,0.0
6118,The Last Rampage,12944,6294,6650,movies-2017.csv,2017,0.48624845488257107,0.5137515451174289
6119,A Green Story,12901,12901,0,movies-2013.csv,2013,1.0,0.0
6120,Taipei Story,12897,12897,0,movies-2017.csv,2017,1.0,0.0
6121,Permanent,12847,12847,0,movies-2017.csv,2017,1.0,0.0
6122,Junction 48,12795,12795,0,movies-2017.csv,2017,1.0,0.0
6123,Yakuza Apocalypse,12756,12756,0,movies-2015.csv,2015,1.0,0.0
6124,Virginia,12728,12728,0,movies-2012.csv,2012,1.0,0.0
6125,Breakdance Academy 2013 Re-release,12708,12708,0,movies-2013.csv,2013,1.0,0.0
6126,Concerning Violence,12680,12680,0,movies-2014.csv,2014,1.0,0.0
6127,Heal,12668,12668,0,movies-2017.csv,2017,1.0,0.0
6128,Bhopal: A Prayer for Rain,12628,12628,0,movies-2014.csv,2014,1.0,0.0
6129,Kangaroo,12626,4547,8079,movies-2018.csv,2018,0.3601298907017266,0.6398701092982734
6130,American Socialist: The Life and Times of Eugene Victor Debs,12609,12609,0,movies-2018.csv,2018,1.0,0.0
6131,Boy Meets Girl,12589,12589,0,movies-2014.csv,2014,1.0,0.0
6132,Husbands in Goa,12588,10135,2453,movies-2012.csv,2012,0.8051318716237686,0.19486812837623133
6133,Of Fathers and Sons,12579,12579,0,movies-2018.csv,2018,1.0,0.0
6134,Around June,12578,12578,0,movies-2012.csv,2012,1.0,0.0
6135,My Art,12554,12554,0,movies-2018.csv,2018,1.0,0.0
6136,Off Season,12544,12544,0,movies-2019.csv,2019,1.0,0.0
6137,City of Women,12516,12516,0,movies-2016.csv,2016,1.0,0.0
6138,Seven Beauties,12408,12408,0,movies-2017.csv,2017,1.0,0.0
6139,Killer Raccoons! 2! Dark Christmas in the Dark!,12382,12382,0,movies-2020.csv,2020,1.0,0.0
6140,American Chaos,12368,12368,0,movies-2018.csv,2018,1.0,0.0
6141,America the Beautiful 2: The Thin Commandments,12366,12366,0,movies-2011.csv,2011,1.0,0.0
6142,Rebirth,12358,12358,0,movies-2011.csv,2011,1.0,0.0
6143,L'héritage de la chouette,12316,12316,0,movies-2018.csv,2018,1.0,0.0
6144,4 Days in France,12273,12273,0,movies-2017.csv,2017,1.0,0.0
6145,The Armor of Light,12267,12267,0,movies-2015.csv,2015,1.0,0.0
6146,Wa-shoku Dream: Beyond Sushi,12240,12240,0,movies-2015.csv,2015,1.0,0.0
6147,Bricked,12201,12201,0,movies-2019.csv,2019,1.0,0.0
6148,Elstree 1976,12173,12173,0,movies-2016.csv,2016,1.0,0.0
6149,Destiny,12156,12156,0,movies-2016.csv,2016,1.0,0.0
6150,Touch the Wall,12156,12156,0,movies-2014.csv,2014,1.0,0.0
6151,Greetings from Tim Buckley,12155,11157,998,movies-2013.csv,2013,0.9178938708350473,0.08210612916495269
6152,Back Door Channels: The Price of Peace,12139,12139,0,movies-2011.csv,2011,1.0,0.0
6153,In No Great Hurry: 13 Lessons in Life with Saul Leiter,12133,12133,0,movies-2014.csv,2014,1.0,0.0
6154,The Most Unknown,12119,12119,0,movies-2018.csv,2018,1.0,0.0
6155,Call Me Kuchu,12110,9124,2986,movies-2012.csv,2012,0.7534269199009084,0.24657308009909165
6156,Zen for Nothing,12107,12107,0,movies-2019.csv,2019,1.0,0.0
6157,Hot Water,12101,12101,0,movies-2016.csv,2016,1.0,0.0
6158,A Murder in the Park,12088,12088,0,movies-2015.csv,2015,1.0,0.0
6159,When Two Worlds Collide,12080,12080,0,movies-2016.csv,2016,1.0,0.0
6160,Little England 2015 Re-release,12077,12077,0,movies-2015.csv,2015,1.0,0.0
6161,Imprisoned,12050,12050,0,movies-2019.csv,2019,1.0,0.0
6162,Quartet,12042,12042,0,movies-2019.csv,2019,1.0,0.0
6163,Lost Angels: Skid Row Is My Home,12025,12025,0,movies-2012.csv,2012,1.0,0.0
6164,Queen Margot 2014 Re-release,12005,12005,0,movies-2014.csv,2014,1.0,0.0
6165,Autumn Sonata 2017 Re-release,11959,0,11959,movies-2017.csv,2017,0.0,1.0
6166,The Strange Little Cat,11956,5885,6071,movies-2014.csv,2014,0.4922214787554366,0.5077785212445634
6167,The Last Race,11947,11947,0,movies-2018.csv,2018,1.0,0.0
6168,Frank Serpico,11925,11925,0,movies-2017.csv,2017,1.0,0.0
6169,"Cassandro, The Exotico!",11897,11897,0,movies-2019.csv,2019,1.0,0.0
6170,Hollywould,11888,11888,0,movies-2019.csv,2019,1.0,0.0
6171,Revenge of the Mekons,11861,11861,0,movies-2014.csv,2014,1.0,0.0
6172,Les Parents Terribles,11818,11818,0,movies-2018.csv,2018,1.0,0.0
6173,Emptying the Skies,11811,11811,0,movies-2015.csv,2015,1.0,0.0
6174,Summer '03,11746,11746,0,movies-2018.csv,2018,1.0,0.0
6175,Rid of Me,11740,11740,0,movies-2011.csv,2011,1.0,0.0
6176,Lucha Mexico,11722,11722,0,movies-2016.csv,2016,1.0,0.0
6177,The Grizzlies,11650,11650,0,movies-2020.csv,2020,1.0,0.0
6178,36 Saints,11640,11640,0,movies-2013.csv,2013,1.0,0.0
6179,The Tribes of Palos Verdes,11603,11603,0,movies-2017.csv,2017,1.0,0.0
6180,11 Flowers,11599,9213,2386,movies-2012.csv,2012,0.79429261143202,0.20570738856798
6181,Around India with a Movie Camera,11568,10389,1179,movies-2018.csv,2018,0.8980809128630706,0.10191908713692946
6182,The Preppie Connection,11558,11558,0,movies-2016.csv,2016,1.0,0.0
6183,River of Grass,11553,11553,0,movies-2016.csv,2016,1.0,0.0
6184,The Ruins of Lifta,11548,11548,0,movies-2016.csv,2016,1.0,0.0
6185,Ultrasuede: In Search of Halston,11539,11539,0,movies-2012.csv,2012,1.0,0.0
6186,Elektra Luxx,11514,11514,0,movies-2011.csv,2011,1.0,0.0
6187,The Great Invisible,11428,11428,0,movies-2014.csv,2014,1.0,0.0
6188,The Final Member,11428,11428,0,movies-2014.csv,2014,1.0,0.0
6189,Beside Bowie: The Mick Ronson Story,11400,11400,0,movies-2017.csv,2017,1.0,0.0
6190,Rendezvous in July,11321,11321,0,movies-2018.csv,2018,1.0,0.0
6191,Powerbomb,11319,11319,0,movies-2020.csv,2020,1.0,0.0
6192,Draupadi Unleashed,11317,11317,0,movies-2020.csv,2020,1.0,0.0
6193,Saigon Bodyguards,11314,11314,0,movies-2017.csv,2017,1.0,0.0
6194,Viktoria,11314,11314,0,movies-2016.csv,2016,1.0,0.0
6195,Lost in America,11301,11301,0,movies-2020.csv,2020,1.0,0.0
6196,Dishkiyaoon,11288,11288,0,movies-2014.csv,2014,1.0,0.0
6197,Theo Who Lived,11271,11271,0,movies-2016.csv,2016,1.0,0.0
6198,Bullitt County,11257,11257,0,movies-2018.csv,2018,1.0,0.0
6199,Daylight's End,11257,0,11257,movies-2016.csv,2016,0.0,1.0
6200,In Like Flynn,11255,11255,0,movies-2019.csv,2019,1.0,0.0
6201,Hacker,11239,11239,0,movies-2016.csv,2016,1.0,0.0
6202,The Pathological Optimist,11222,11222,0,movies-2017.csv,2017,1.0,0.0
6203,Made Me Do It,11151,11151,0,movies-2019.csv,2019,1.0,0.0
6204,"Now, Forager",11146,11146,0,movies-2012.csv,2012,1.0,0.0
6205,InSight,11100,11100,0,movies-2011.csv,2011,1.0,0.0
6206,The Black Book of Father Dinis,11057,0,11057,movies-2018.csv,2018,0.0,1.0
6207,Edward II 2018 Re-release,11055,4826,6229,movies-2018.csv,2018,0.4365445499773858,0.5634554500226142
6208,The Challenge,11043,11043,0,movies-2017.csv,2017,1.0,0.0
6209,The Woman with the 5 Elephants 2011 Re-release,11026,11026,0,movies-2011.csv,2011,1.0,0.0
6210,PAY 2 PLAY: Democracy's High Stakes,11021,11021,0,movies-2014.csv,2014,1.0,0.0
6211,Midget Zombie Takeover,11006,11006,0,movies-2013.csv,2013,1.0,0.0
6212,Suburban Birds,10997,10997,0,movies-2019.csv,2019,1.0,0.0
6213,16 Bars,10985,10985,0,movies-2019.csv,2019,1.0,0.0
6214,Just Before I Go,10970,10970,0,movies-2015.csv,2015,1.0,0.0
6215,Digging Up the Marrow,10969,10969,0,movies-2015.csv,2015,1.0,0.0
6216,Very Good Girls,10963,6940,4023,movies-2014.csv,2014,0.6330384018972909,0.3669615981027091
6217,Wallander: Hämnden 2012 Re-release,10960,10960,0,movies-2012.csv,2012,1.0,0.0
6218,Sarah Palin: You Betcha!,10935,10935,0,movies-2011.csv,2011,1.0,0.0
6219,If the Dancer Dances,10912,10912,0,movies-2019.csv,2019,1.0,0.0
6220,As It Is in Heaven,10850,10850,0,movies-2014.csv,2014,1.0,0.0
6221,What Happened Last Night,10844,10844,0,movies-2016.csv,2016,1.0,0.0
6222,The Forecaster,10824,10172,652,movies-2015.csv,2015,0.9397634885439764,0.06023651145602365
6223,Bleeding Heart,10815,0,10815,movies-2015.csv,2015,0.0,1.0
6224,The Man Who Shook the Hand of Vicente Fernandez,10782,10782,0,movies-2012.csv,2012,1.0,0.0
6225,Vision Portraits,10771,10771,0,movies-2019.csv,2019,1.0,0.0
6226,Mala Mala,10761,10761,0,movies-2015.csv,2015,1.0,0.0
6227,A Resurrection,10730,10730,0,movies-2013.csv,2013,1.0,0.0
6228,Hollow in the Land,10688,0,10688,movies-2017.csv,2017,0.0,1.0
6229,You Go to My Head,10682,10682,0,movies-2020.csv,2020,1.0,0.0
6230,Made in Cleveland,10681,10681,0,movies-2013.csv,2013,1.0,0.0
6231,National Bird,10656,10656,0,movies-2016.csv,2016,1.0,0.0
6232,American Meat,10650,10650,0,movies-2013.csv,2013,1.0,0.0
6233,Caucus,10645,10645,0,movies-2013.csv,2013,1.0,0.0
6234,Lovesong,10626,10626,0,movies-2017.csv,2017,1.0,0.0
6235,Intuitions,10606,10606,0,movies-2019.csv,2019,1.0,0.0
6236,Marriage Italian Style 2011 Re-release,10600,10600,0,movies-2011.csv,2011,1.0,0.0
6237,Inside the Mind of Leonardo,10600,10600,0,movies-2014.csv,2014,1.0,0.0
6238,China Heavyweight,10550,10550,0,movies-2012.csv,2012,1.0,0.0
6239,I'll Take Your Dead,10523,10523,0,movies-2019.csv,2019,1.0,0.0
6240,Clarence,10495,10495,0,movies-2017.csv,2017,1.0,0.0
6241,Santa Mesa,10490,10490,0,movies-2012.csv,2012,1.0,0.0
6242,Neon Flesh 2012 Re-release,10483,0,10483,movies-2012.csv,2012,0.0,1.0
6243,"Norte, the End of History",10457,10457,0,movies-2014.csv,2014,1.0,0.0
6244,Evil Intent,10454,10454,0,movies-2013.csv,2013,1.0,0.0
6245,Class Rank,10452,10452,0,movies-2018.csv,2018,1.0,0.0
6246,Mama Africa 2018 Re-release,10430,10430,0,movies-2018.csv,2018,1.0,0.0
6247,The Advocates,10402,10402,0,movies-2018.csv,2018,1.0,0.0
6248,Shanghai Calling,10400,10400,0,movies-2013.csv,2013,1.0,0.0
6249,Elemental,10358,10358,0,movies-2013.csv,2013,1.0,0.0
6250,Zero Bridge,10357,10357,0,movies-2011.csv,2011,1.0,0.0
6251,SK1 2016 Re-release,10330,10330,0,movies-2016.csv,2016,1.0,0.0
6252,Painted Woman,10298,10298,0,movies-2017.csv,2017,1.0,0.0
6253,Shepard & Dark,10278,10278,0,movies-2013.csv,2013,1.0,0.0
6254,Moebius,10254,2340,7914,movies-2014.csv,2014,0.22820362785254536,0.7717963721474547
6255,Coded Bias,10236,10236,0,movies-2020.csv,2020,1.0,0.0
6256,The Endless Summer,10233,10233,0,movies-2014.csv,2014,1.0,0.0
6257,Amelia 2.0,10233,10233,0,movies-2017.csv,2017,1.0,0.0
6258,Approaching the Unknown,10232,10232,0,movies-2016.csv,2016,1.0,0.0
6259,Tip Top,10201,6050,4151,movies-2013.csv,2013,0.5930791098911872,0.4069208901088129
6260,When Lambs Become Lions,10197,9337,860,movies-2019.csv,2019,0.9156614690595273,0.0843385309404727
6261,Prince of the Himalayas,10190,10190,0,movies-2011.csv,2011,1.0,0.0
6262,Miss Minoes 2011 Re-release,10189,10189,0,movies-2011.csv,2011,1.0,0.0
6263,A Bird of the Air,10152,10152,0,movies-2011.csv,2011,1.0,0.0
6264,Beta Test,10104,10104,0,movies-2016.csv,2016,1.0,0.0
6265,Putin's Kiss,10082,10082,0,movies-2012.csv,2012,1.0,0.0
6266,Pawn Shop Chronicles,10080,8088,1992,movies-2013.csv,2013,0.8023809523809524,0.1976190476190476
6267,Before I Disappear,10078,10078,0,movies-2014.csv,2014,1.0,0.0
6268,Little Accidents,10071,10071,0,movies-2015.csv,2015,1.0,0.0
6269,Informant,10068,10068,0,movies-2013.csv,2013,1.0,0.0
6270,The Sunshine Makers,10042,10042,0,movies-2017.csv,2017,1.0,0.0
6271,The Life and Mind of Mark DeFriest,10021,10021,0,movies-2015.csv,2015,1.0,0.0
6272,Guest Artist,10017,10017,0,movies-2020.csv,2020,1.0,0.0
6273,Arjun: The Warrior Prince,10017,10017,0,movies-2012.csv,2012,1.0,0.0
6274,The Do-Deca-Pentathlon,10000,10000,0,movies-2012.csv,2012,1.0,0.0
6275,Tere Bin Laden: Dead Or Alive,9995,0,9995,movies-2016.csv,2016,0.0,1.0
6276,Foosballers,9966,9966,0,movies-2020.csv,2020,1.0,0.0
6277,Made in France,9956,9956,0,movies-2016.csv,2016,1.0,0.0
6278,Olivia,9934,9934,0,movies-2019.csv,2019,1.0,0.0
6279,Streetwise,9904,9904,0,movies-2019.csv,2019,1.0,0.0
6280,52 Tuesdays,9844,0,9844,movies-2015.csv,2015,0.0,1.0
6281,Kabbalah Me,9816,9816,0,movies-2014.csv,2014,1.0,0.0
6282,Birth of the Living Dead,9802,9802,0,movies-2013.csv,2013,1.0,0.0
6283,Pelle the Conqueror 2017 Re-release,9757,9757,0,movies-2017.csv,2017,1.0,0.0
6284,"If You Don't, I Will",9719,9719,0,movies-2014.csv,2014,1.0,0.0
6285,Antoine & Antoinette,9704,9704,0,movies-2013.csv,2013,1.0,0.0
6286,The Quest of Alain Ducasse,9627,9627,0,movies-2018.csv,2018,1.0,0.0
6287,The Spanish Prisoner 2019 Re-release,9589,9589,0,movies-2019.csv,2019,1.0,0.0
6288,Vito Bonafacci,9570,9570,0,movies-2011.csv,2011,1.0,0.0
6289,Chosen,9536,9283,253,movies-2016.csv,2016,0.9734689597315436,0.026531040268456377
6290,The Lost Arcade,9522,9522,0,movies-2016.csv,2016,1.0,0.0
6291,Strangers on the Earth,9518,9518,0,movies-2018.csv,2018,1.0,0.0
6292,Living Proof,9512,9512,0,movies-2017.csv,2017,1.0,0.0
6293,In the House of Flies,9480,9480,0,movies-2014.csv,2014,1.0,0.0
6294,Northern Lights,9453,9453,0,movies-2013.csv,2013,1.0,0.0
6295,If I Were You,9432,9432,0,movies-2013.csv,2013,1.0,0.0
6296,Zero Charisma,9417,9417,0,movies-2013.csv,2013,1.0,0.0
6297,"One Cut, One Life",9406,9406,0,movies-2015.csv,2015,1.0,0.0
6298,Miss Kiet's Children 2017 Re-release,9384,9384,0,movies-2017.csv,2017,1.0,0.0
6299,The Tree of Wooden Clogs,9367,0,9367,movies-2016.csv,2016,0.0,1.0
6300,Radio Free Albemuth,9365,9365,0,movies-2014.csv,2014,1.0,0.0
6301,Fritz Lang's Indian Epic 2019 re-release,9345,9345,0,movies-2019.csv,2019,1.0,0.0
6302,The End of Love,9342,9342,0,movies-2013.csv,2013,1.0,0.0
6303,Looking for Maria Sanchez,9338,9338,0,movies-2013.csv,2013,1.0,0.0
6304,The Immortalists,9331,9331,0,movies-2014.csv,2014,1.0,0.0
6305,Better Mus' Come,9318,9318,0,movies-2013.csv,2013,1.0,0.0
6306,The City Dark,9269,9269,0,movies-2012.csv,2012,1.0,0.0
6307,Hooligan Sparrow,9263,9263,0,movies-2016.csv,2016,1.0,0.0
6308,The Sacrament,9221,9221,0,movies-2014.csv,2014,1.0,0.0
6309,A Dark Place,9212,0,9212,movies-2019.csv,2019,0.0,1.0
6310,Cracked Up,9197,9197,0,movies-2019.csv,2019,1.0,0.0
6311,Ghost Team One,9195,9195,0,movies-2013.csv,2013,1.0,0.0
6312,Trouble Every Day 2013 Re-release,9189,9189,0,movies-2013.csv,2013,1.0,0.0
6313,Frank & Lola,9188,9188,0,movies-2016.csv,2016,1.0,0.0
6314,The Hottest August,9163,9163,0,movies-2019.csv,2019,1.0,0.0
6315,The Hollow Point,9149,0,9149,movies-2016.csv,2016,0.0,1.0
6316,Just One More Kiss,9130,9130,0,movies-2020.csv,2020,1.0,0.0
6317,Thirst Street,9129,9129,0,movies-2017.csv,2017,1.0,0.0
6318,Cupcakes,9129,9129,0,movies-2015.csv,2015,1.0,0.0
6319,Faith Connections,9111,9111,0,movies-2014.csv,2014,1.0,0.0
6320,Lycan,9110,9110,0,movies-2017.csv,2017,1.0,0.0
6321,The Eyes,9104,9104,0,movies-2017.csv,2017,1.0,0.0
6322,Julian Schnabel: A Private Portrait,9103,9103,0,movies-2017.csv,2017,1.0,0.0
6323,Decoding Deepak,9100,9100,0,movies-2012.csv,2012,1.0,0.0
6324,Gerontophilia 2015 Re-release,9074,4916,4158,movies-2015.csv,2015,0.541767687899493,0.45823231210050697
6325,El Mar La Mar,9065,9065,0,movies-2018.csv,2018,1.0,0.0
6326,Frantz Fanon: Black Skin White Mask,9025,9025,0,movies-2019.csv,2019,1.0,0.0
6327,Step Up: High Water,9005,9005,0,movies-2018.csv,2018,1.0,0.0
6328,Money Fight,9004,9004,0,movies-2012.csv,2012,1.0,0.0
6329,Mosquita y Mari,9000,9000,0,movies-2012.csv,2012,1.0,0.0
6330,Station to Station,9000,9000,0,movies-2015.csv,2015,1.0,0.0
6331,Zoo Wars,8998,8998,0,movies-2018.csv,2018,1.0,0.0
6332,Revolt,8986,0,8986,movies-2017.csv,2017,0.0,1.0
6333,Survivors Guide To Prison,8982,8982,0,movies-2018.csv,2018,1.0,0.0
6334,Colossal Youth,8968,8331,637,movies-2018.csv,2018,0.9289696699375558,0.07103033006244425
6335,Big Words,8965,8965,0,movies-2013.csv,2013,1.0,0.0
6336,Three Stars,8942,8942,0,movies-2012.csv,2012,1.0,0.0
6337,Summer of '67,8941,8941,0,movies-2018.csv,2018,1.0,0.0
6338,Kindred,8921,8921,0,movies-2020.csv,2020,1.0,0.0
6339,This is Congo,8905,7051,1854,movies-2018.csv,2018,0.7918023582257159,0.2081976417742841
6340,B-Side,8870,8870,0,movies-2015.csv,2015,1.0,0.0
6341,The Meanest Man in Texas,8850,8850,0,movies-2019.csv,2019,1.0,0.0
6342,The Pardon,8845,8845,0,movies-2015.csv,2015,1.0,0.0
6343,Providence,8840,8840,0,movies-2016.csv,2016,1.0,0.0
6344,Home Run Showdown,8824,8824,0,movies-2012.csv,2012,1.0,0.0
6345,That Part Feeling - the Universe of Arvo Part,8812,8812,0,movies-2019.csv,2019,1.0,0.0
6346,The Cabinet of Dr. Caligari 2014 Re-release,8811,8811,0,movies-2014.csv,2014,1.0,0.0
6347,Dawn of the Crescent Moon,8799,8799,0,movies-2015.csv,2015,1.0,0.0
6348,Hell Baby,8785,8785,0,movies-2013.csv,2013,1.0,0.0
6349,The Man in the White Suit,8718,8718,0,movies-2012.csv,2012,1.0,0.0
6350,Blood Feast,8708,8708,0,movies-2018.csv,2018,1.0,0.0
6351,Amnesia,8700,8700,0,movies-2017.csv,2017,1.0,0.0
6352,Man on a Mission: Richard Garriott's Road to the Stars,8688,8688,0,movies-2012.csv,2012,1.0,0.0
6353,Dosed,8643,0,8643,movies-2019.csv,2019,0.0,1.0
6354,"Small, Beautifully Moving Parts",8631,8631,0,movies-2012.csv,2012,1.0,0.0
6355,Meet Me in Montenegro,8612,8612,0,movies-2015.csv,2015,1.0,0.0
6356,Almost Human,8608,8447,161,movies-2014.csv,2014,0.981296468401487,0.018703531598513012
6357,Mojave,8602,8253,349,movies-2016.csv,2016,0.9594280399906998,0.04057196000930016
6358,General Education,8601,8601,0,movies-2012.csv,2012,1.0,0.0
6359,Farewell to Hollywood,8601,8601,0,movies-2015.csv,2015,1.0,0.0
6360,Lucky,8564,8564,0,movies-2011.csv,2011,1.0,0.0
6361,From the East,8540,8540,0,movies-2016.csv,2016,1.0,0.0
6362,Inspector Maigret,8528,8528,0,movies-2017.csv,2017,1.0,0.0
6363,The Quitter,8512,8512,0,movies-2014.csv,2014,1.0,0.0
6364,The Empty Hours,8478,8244,234,movies-2014.csv,2014,0.9723991507430998,0.027600849256900213
6365,Furlough,8472,8472,0,movies-2018.csv,2018,1.0,0.0
6366,Canopy,8462,8462,0,movies-2014.csv,2014,1.0,0.0
6367,The Institute,8445,8445,0,movies-2013.csv,2013,1.0,0.0
6368,We Are the Flesh,8438,8438,0,movies-2017.csv,2017,1.0,0.0
6369,Hello Herman,8437,8437,0,movies-2013.csv,2013,1.0,0.0
6370,Red Hollywood,8426,8426,0,movies-2014.csv,2014,1.0,0.0
6371,The Happy Sad,8395,8395,0,movies-2013.csv,2013,1.0,0.0
6372,LX 2048,8393,0,8393,movies-2020.csv,2020,0.0,1.0
6373,Downloaded,8377,8377,0,movies-2013.csv,2013,1.0,0.0
6374,Counting,8374,8374,0,movies-2015.csv,2015,1.0,0.0
6375,Gilbert,8362,8362,0,movies-2017.csv,2017,1.0,0.0
6376,Eternity: The Movie,8350,8350,0,movies-2014.csv,2014,1.0,0.0
6377,Gringo Trails,8349,8349,0,movies-2014.csv,2014,1.0,0.0
6378,A Teacher,8348,8348,0,movies-2013.csv,2013,1.0,0.0
6379,Natasha,8325,8325,0,movies-2017.csv,2017,1.0,0.0
6380,The Dead Center,8320,8320,0,movies-2019.csv,2019,1.0,0.0
6381,About Cherry,8315,3003,5312,movies-2012.csv,2012,0.36115453998797353,0.6388454600120265
6382,Mr. Chibbs,8302,8302,0,movies-2017.csv,2017,1.0,0.0
6383,Served Like a Girl,8290,8290,0,movies-2017.csv,2017,1.0,0.0
6384,We Are Twisted Fucking Sister!,8277,8277,0,movies-2016.csv,2016,1.0,0.0
6385,Life Partners,8265,8265,0,movies-2014.csv,2014,1.0,0.0
6386,Aliyah,8253,8253,0,movies-2013.csv,2013,1.0,0.0
6387,Silicon Cowboys,8239,8239,0,movies-2016.csv,2016,1.0,0.0
6388,The Etruscan Smile 2019 release,8213,8213,0,movies-2019.csv,2019,1.0,0.0
6389,Brooklyn Brothers Beat the Best,8210,7466,744,movies-2012.csv,2012,0.9093788063337394,0.09062119366626066
6390,Spiral,8190,8190,0,movies-2018.csv,2018,1.0,0.0
6391,Jellyfish Eyes,8176,8176,0,movies-2015.csv,2015,1.0,0.0
6392,Anatahan,8171,8171,0,movies-2017.csv,2017,1.0,0.0
6393,The Other Side,8168,8074,94,movies-2016.csv,2016,0.9884916748285995,0.011508325171400588
6394,Inside the Rain,8140,8140,0,movies-2020.csv,2020,1.0,0.0
6395,Far from Vietnam,8132,8132,0,movies-2013.csv,2013,1.0,0.0
6396,From Nowhere,8109,8109,0,movies-2017.csv,2017,1.0,0.0
6397,The Wave,8101,8101,0,movies-2020.csv,2020,1.0,0.0
6398,Restless City,8100,8100,0,movies-2012.csv,2012,1.0,0.0
6399,Next Year Jerusalem,8093,8093,0,movies-2014.csv,2014,1.0,0.0
6400,Golden Kingdom,8077,8077,0,movies-2016.csv,2016,1.0,0.0
6401,Steak (R)evolution,8038,8025,13,movies-2015.csv,2015,0.9983826822592685,0.0016173177407315252
6402,Straight Outta Tompkins,8022,8022,0,movies-2015.csv,2015,1.0,0.0
6403,Talent Has Hunger,7998,7998,0,movies-2016.csv,2016,1.0,0.0
6404,One Small Hitch 2015 Re-release,7965,7965,0,movies-2015.csv,2015,1.0,0.0
6405,Roseanne for President!,7960,7960,0,movies-2016.csv,2016,1.0,0.0
6406,Angels Are Made Of Light,7919,7919,0,movies-2019.csv,2019,1.0,0.0
6407,Portrait of a Garden,7914,7914,0,movies-2016.csv,2016,1.0,0.0
6408,Bleak Street,7888,0,7888,movies-2015.csv,2015,0.0,1.0
6409,This Magnificent Cake!,7888,7888,0,movies-2019.csv,2019,1.0,0.0
6410,I AM PATRICK,7880,0,7880,movies-2020.csv,2020,0.0,1.0
6411,Swept Away,7876,7876,0,movies-2017.csv,2017,1.0,0.0
6412,The Ballad of Lefty Brown,7856,7856,0,movies-2017.csv,2017,1.0,0.0
6413,Ghost Fleet,7850,7850,0,movies-2019.csv,2019,1.0,0.0
6414,Roadie,7825,7825,0,movies-2012.csv,2012,1.0,0.0
6415,Photographic Memory,7822,7822,0,movies-2012.csv,2012,1.0,0.0
6416,The Great Man,7814,7814,0,movies-2015.csv,2015,1.0,0.0
6417,Archipelago 2014 Re-release,7791,7791,0,movies-2014.csv,2014,1.0,0.0
6418,Dreaming Grand Avenue,7789,7789,0,movies-2020.csv,2020,1.0,0.0
6419,The Plagiarists,7768,7768,0,movies-2019.csv,2019,1.0,0.0
6420,Old Stone,7768,7476,292,movies-2016.csv,2016,0.962409886714727,0.03759011328527292
6421,And While We Were Here,7750,7750,0,movies-2013.csv,2013,1.0,0.0
6422,Come Back to Me,7744,7744,0,movies-2014.csv,2014,1.0,0.0
6423,Young Ones,7740,0,7740,movies-2014.csv,2014,0.0,1.0
6424,Gregory's Girl,7710,7710,0,movies-2019.csv,2019,1.0,0.0
6425,Maurizio Cattelan: Be Right Back,7706,7706,0,movies-2017.csv,2017,1.0,0.0
6426,I Don't Belong Anywhere: The Cinema of Chantal Akerman,7703,7703,0,movies-2016.csv,2016,1.0,0.0
6427,Running Shaadi,7674,0,7674,movies-2017.csv,2017,0.0,1.0
6428,Valley Girl,7671,0,7671,movies-2020.csv,2020,0.0,1.0
6429,Last Days Here,7643,7643,0,movies-2012.csv,2012,1.0,0.0
6430,Legend of the Mountain,7640,7640,0,movies-2018.csv,2018,1.0,0.0
6431,Psycho Raman,7612,0,7612,movies-2016.csv,2016,0.0,1.0
6432,Area 51,7556,7556,0,movies-2015.csv,2015,1.0,0.0
6433,The Wrong Light,7553,7553,0,movies-2017.csv,2017,1.0,0.0
6434,Girls Against Boys,7529,7529,0,movies-2013.csv,2013,1.0,0.0
6435,Birthright: A War Story,7519,7519,0,movies-2017.csv,2017,1.0,0.0
6436,The Little Bedroom 2014 Re-release,7440,7440,0,movies-2014.csv,2014,1.0,0.0
6437,Raze,7429,7429,0,movies-2014.csv,2014,1.0,0.0
6438,Bel Borba Aqui,7426,7426,0,movies-2012.csv,2012,1.0,0.0
6439,Rubble Kings,7416,7416,0,movies-2015.csv,2015,1.0,0.0
6440,Price Check,7413,7413,0,movies-2012.csv,2012,1.0,0.0
6441,The Giant Mechanical Man,7396,7396,0,movies-2012.csv,2012,1.0,0.0
6442,The Other Lamb,7385,6024,1361,movies-2020.csv,2020,0.8157075152335815,0.1842924847664184
6443,Desperate Acts of Magic,7373,7373,0,movies-2013.csv,2013,1.0,0.0
6444,Big Time,7347,7347,0,movies-2017.csv,2017,1.0,0.0
6445,Shoah: Four Sisters,7323,7323,0,movies-2018.csv,2018,1.0,0.0
6446,Beloved Beast,7301,7301,0,movies-2019.csv,2019,1.0,0.0
6447,Another WolfCop,7285,7285,0,movies-2017.csv,2017,1.0,0.0
6448,Indian Point,7251,7251,0,movies-2016.csv,2016,1.0,0.0
6449,Outside Satan,7226,0,7226,movies-2013.csv,2013,0.0,1.0
6450,Tall: The American Skyscraper and Louis Sullivan,7216,7216,0,movies-2018.csv,2018,1.0,0.0
6451,I Am Ali,7205,7205,0,movies-2014.csv,2014,1.0,0.0
6452,London River 2011 Re-release,7200,7200,0,movies-2011.csv,2011,1.0,0.0
6453,Antarctic Edge: 70° South,7193,7193,0,movies-2015.csv,2015,1.0,0.0
6454,The Strange Color of Your Body's Tears,7182,7182,0,movies-2014.csv,2014,1.0,0.0
6455,ABCs of Death 2,7171,7171,0,movies-2014.csv,2014,1.0,0.0
6456,It Had to Be You,7162,7162,0,movies-2016.csv,2016,1.0,0.0
6457,"Brutti, sporchi e cattivi",7144,7144,0,movies-2016.csv,2016,1.0,0.0
6458,The Reagan Show,7109,5500,1609,movies-2017.csv,2017,0.7736671824447883,0.2263328175552117
6459,Domain 2012 Re-release,7105,7105,0,movies-2012.csv,2012,1.0,0.0
6460,The Jazz Funeral,7103,7103,0,movies-2017.csv,2017,1.0,0.0
6461,The Dark Below,7095,7095,0,movies-2017.csv,2017,1.0,0.0
6462,Painless,7082,7082,0,movies-2018.csv,2018,1.0,0.0
6463,Stage Fright,7078,7078,0,movies-2014.csv,2014,1.0,0.0
6464,In Echo Park,7072,7072,0,movies-2018.csv,2018,1.0,0.0
6465,Good Neighbours,7072,7072,0,movies-2011.csv,2011,1.0,0.0
6466,The Brainwashing of My Dad,7028,7028,0,movies-2016.csv,2016,1.0,0.0
6467,In the Land of Pomegranates,7014,7014,0,movies-2018.csv,2018,1.0,0.0
6468,Corman's World: Exploits of a Hollywood Rebel,7000,7000,0,movies-2011.csv,2011,1.0,0.0
6469,The Brass Teapot,6997,6997,0,movies-2013.csv,2013,1.0,0.0
6470,I Am Lisa,6986,6986,0,movies-2020.csv,2020,1.0,0.0
6471,What We Found,6976,6976,0,movies-2020.csv,2020,1.0,0.0
6472,Gabriel,6959,6959,0,movies-2015.csv,2015,1.0,0.0
6473,"Love, Marilyn",6950,6950,0,movies-2012.csv,2012,1.0,0.0
6474,A Kind of Loving,6912,6912,0,movies-2017.csv,2017,1.0,0.0
6475,Assaulted: Civil Rights Under Fire,6905,6905,0,movies-2013.csv,2013,1.0,0.0
6476,Boom Bust Boom,6896,6896,0,movies-2016.csv,2016,1.0,0.0
6477,Sal,6883,6883,0,movies-2013.csv,2013,1.0,0.0
6478,The Human Scale,6878,6878,0,movies-2013.csv,2013,1.0,0.0
6479,Duck Butter,6877,6877,0,movies-2018.csv,2018,1.0,0.0
6480,The Sisterhood of Night,6870,6870,0,movies-2015.csv,2015,1.0,0.0
6481,Last Ride 2012 Re-release,6853,6853,0,movies-2012.csv,2012,1.0,0.0
6482,Janie Jones,6840,6840,0,movies-2011.csv,2011,1.0,0.0
6483,Mad Tiger,6823,6823,0,movies-2016.csv,2016,1.0,0.0
6484,12 Hour Shift,6820,6820,0,movies-2020.csv,2020,1.0,0.0
6485,"No God, No Master",6796,6796,0,movies-2014.csv,2014,1.0,0.0
6486,Going Attractions: The Definitive Story of the Movie Palace,6763,6763,0,movies-2019.csv,2019,1.0,0.0
6487,Calling All Earthlings,6756,6756,0,movies-2018.csv,2018,1.0,0.0
6488,Dying to Survive 2019 Re-release,6752,6752,0,movies-2019.csv,2019,1.0,0.0
6489,A Whale of a Tale,6747,6747,0,movies-2018.csv,2018,1.0,0.0
6490,Iceman,6719,2138,4581,movies-2018.csv,2018,0.3182021134097336,0.6817978865902664
6491,Before You Know It,6717,6717,0,movies-2014.csv,2014,1.0,0.0
6492,Arabian Nights: Volume 3 - The Enchanted One,6681,4502,2179,movies-2015.csv,2015,0.6738512198772639,0.3261487801227361
6493,Footnotes 2017 Re-release,6660,6660,0,movies-2017.csv,2017,1.0,0.0
6494,Ghost Team,6639,6639,0,movies-2016.csv,2016,1.0,0.0
6495,The Persian Connection,6634,6634,0,movies-2017.csv,2017,1.0,0.0
6496,Breakfast with Curtis,6629,6629,0,movies-2013.csv,2013,1.0,0.0
6497,The Dying of the Light,6627,6627,0,movies-2016.csv,2016,1.0,0.0
6498,Aatsinki: The Story of Arctic Cowboys,6601,6601,0,movies-2014.csv,2014,1.0,0.0
6499,Brief Reunion,6601,6601,0,movies-2013.csv,2013,1.0,0.0
6500,Human Capital,6596,6596,0,movies-2020.csv,2020,1.0,0.0
6501,Down the Shore,6558,6558,0,movies-2013.csv,2013,1.0,0.0
6502,In Our Nature,6543,6543,0,movies-2012.csv,2012,1.0,0.0
6503,Elizabeth Blue,6542,6542,0,movies-2017.csv,2017,1.0,0.0
6504,Spiral Farm,6517,6517,0,movies-2019.csv,2019,1.0,0.0
6505,Horse Money,6508,6508,0,movies-2015.csv,2015,1.0,0.0
6506,Jews of Egypt,6505,6505,0,movies-2014.csv,2014,1.0,0.0
6507,Windfall,6504,6504,0,movies-2012.csv,2012,1.0,0.0
6508,Ride,6489,0,6489,movies-2015.csv,2015,0.0,1.0
6509,The Beat Hotel,6480,6480,0,movies-2012.csv,2012,1.0,0.0
6510,Afterward,6477,6477,0,movies-2020.csv,2020,1.0,0.0
6511,Scum,6461,6461,0,movies-2017.csv,2017,1.0,0.0
6512,Tu Dors Nicole,6445,5662,783,movies-2015.csv,2015,0.8785104732350659,0.12148952676493406
6513,The Suicide Theory,6434,6434,0,movies-2015.csv,2015,1.0,0.0
6514,Some Velvet Morning,6420,6420,0,movies-2013.csv,2013,1.0,0.0
6515,100 Bloody Acres,6388,6388,0,movies-2013.csv,2013,1.0,0.0
6516,Inescapable,6334,6334,0,movies-2013.csv,2013,1.0,0.0
6517,The Charnel House,6332,6332,0,movies-2016.csv,2016,1.0,0.0
6518,Manuscripts Don't Burn,6295,6295,0,movies-2014.csv,2014,1.0,0.0
6519,Under the Eiffel Tower,6291,6291,0,movies-2019.csv,2019,1.0,0.0
6520,The Skyjacker's Tale,6253,6253,0,movies-2017.csv,2017,1.0,0.0
6521,One Last Thing,6232,6232,0,movies-2018.csv,2018,1.0,0.0
6522,In the Steps of Trisha Brown,6230,6230,0,movies-2017.csv,2017,1.0,0.0
6523,The Bad Kids,6226,6226,0,movies-2016.csv,2016,1.0,0.0
6524,A Man Vanishes 2012 Re-release,6201,6201,0,movies-2012.csv,2012,1.0,0.0
6525,The Night of the Shooting Stars 2015 Re-release,6186,6186,0,movies-2015.csv,2015,1.0,0.0
6526,To Be of Service,6173,6173,0,movies-2019.csv,2019,1.0,0.0
6527,Sweetwater,6147,6147,0,movies-2013.csv,2013,1.0,0.0
6528,Crazy Eyes,6141,6141,0,movies-2012.csv,2012,1.0,0.0
6529,Relaxer,6133,6133,0,movies-2019.csv,2019,1.0,0.0
6530,Guitar Innovators: John Fahey & Nels Cline,6132,6132,0,movies-2013.csv,2013,1.0,0.0
6531,"El Sicario, Room 164",6123,6123,0,movies-2011.csv,2011,1.0,0.0
6532,Welcome to Pine Hill,6115,6115,0,movies-2013.csv,2013,1.0,0.0
6533,Arise from Darkness,6112,6112,0,movies-2017.csv,2017,1.0,0.0
6534,Rangrezz,6108,6108,0,movies-2013.csv,2013,1.0,0.0
6535,The Last Fall,6100,6100,0,movies-2012.csv,2012,1.0,0.0
6536,The Last Time I Saw Macao,6095,6095,0,movies-2013.csv,2013,1.0,0.0
6537,The Fuzz,6067,6067,0,movies-2017.csv,2017,1.0,0.0
6538,The Miners' Hymns,6051,6051,0,movies-2012.csv,2012,1.0,0.0
6539,The Marquise of O,6048,6048,0,movies-2015.csv,2015,1.0,0.0
6540,Love & Air Sex,6047,6047,0,movies-2014.csv,2014,1.0,0.0
6541,Blood Widow,6047,6047,0,movies-2019.csv,2019,1.0,0.0
6542,The Family Tree,6035,6035,0,movies-2011.csv,2011,1.0,0.0
6543,On Wings of Eagles 2017 Re-release,5975,5975,0,movies-2017.csv,2017,1.0,0.0
6544,"Sex, Death and Bowling",5972,5972,0,movies-2015.csv,2015,1.0,0.0
6545,The Playroom,5964,5964,0,movies-2013.csv,2013,1.0,0.0
6546,Cavemen,5948,5948,0,movies-2014.csv,2014,1.0,0.0
6547,Starless Dreams,5937,5937,0,movies-2017.csv,2017,1.0,0.0
6548,American Animal,5928,5928,0,movies-2012.csv,2012,1.0,0.0
6549,I Am MLK Jr.,5918,5918,0,movies-2018.csv,2018,1.0,0.0
6550,Gang of Ghosts,5906,5906,0,movies-2014.csv,2014,1.0,0.0
6551,Slash,5902,5902,0,movies-2016.csv,2016,1.0,0.0
6552,Medeas,5895,5895,0,movies-2015.csv,2015,1.0,0.0
6553,An Actor Prepares,5891,1743,4148,movies-2018.csv,2018,0.2958750636564251,0.704124936343575
6554,Infliction,5875,5875,0,movies-2014.csv,2014,1.0,0.0
6555,The Imperialists Are Still Alive!,5874,5874,0,movies-2011.csv,2011,1.0,0.0
6556,Empire of Silver 2011 Re-release,5867,0,5867,movies-2011.csv,2011,0.0,1.0
6557,BuzzKill,5860,5860,0,movies-2012.csv,2012,1.0,0.0
6558,Top Spin,5858,5858,0,movies-2015.csv,2015,1.0,0.0
6559,Bourek,5844,5844,0,movies-2016.csv,2016,1.0,0.0
6560,Shout Gladi Gladi,5839,5839,0,movies-2015.csv,2015,1.0,0.0
6561,Human Nature,5834,5487,347,movies-2019.csv,2019,0.9405210833047651,0.05947891669523483
6562,Five Dances,5788,5788,0,movies-2013.csv,2013,1.0,0.0
6563,Black November,5782,5782,0,movies-2015.csv,2015,1.0,0.0
6564,Undrafted,5777,5777,0,movies-2016.csv,2016,1.0,0.0
6565,Lie Exposed,5775,5775,0,movies-2020.csv,2020,1.0,0.0
6566,In the Life of Music,5772,5772,0,movies-2020.csv,2020,1.0,0.0
6567,Sushi: The Global Catch,5757,5757,0,movies-2012.csv,2012,1.0,0.0
6568,A Dark Truth,5750,5750,0,movies-2013.csv,2013,1.0,0.0
6569,Sex and the Future,5745,5745,0,movies-2020.csv,2020,1.0,0.0
6570,Love Goes Public,5738,5738,0,movies-2019.csv,2019,1.0,0.0
6571,Save the Date,5719,5719,0,movies-2012.csv,2012,1.0,0.0
6572,The Wanted 18,5680,5680,0,movies-2015.csv,2015,1.0,0.0
6573,People of a Feather,5677,5677,0,movies-2013.csv,2013,1.0,0.0
6574,Knife Fight,5661,5661,0,movies-2013.csv,2013,1.0,0.0
6575,Papirosen,5658,5658,0,movies-2014.csv,2014,1.0,0.0
6576,This Isn't Funny,5654,5654,0,movies-2015.csv,2015,1.0,0.0
6577,Série noire,5633,5633,0,movies-2019.csv,2019,1.0,0.0
6578,La Chinoise 2017 Re-release,5631,5631,0,movies-2017.csv,2017,1.0,0.0
6579,Elevate,5580,5580,0,movies-2011.csv,2011,1.0,0.0
6580,Our Man in Tehran,5573,5573,0,movies-2015.csv,2015,1.0,0.0
6581,Kid Cannabis,5565,5565,0,movies-2014.csv,2014,1.0,0.0
6582,Find Your Voice,5560,5560,0,movies-2020.csv,2020,1.0,0.0
6583,The Miracle of the Little Prince,5553,5553,0,movies-2019.csv,2019,1.0,0.0
6584,Booker's Place: A Mississippi Story,5549,5549,0,movies-2012.csv,2012,1.0,0.0
6585,Are We Not Cats,5518,5518,0,movies-2018.csv,2018,1.0,0.0
6586,The Living,5514,5514,0,movies-2015.csv,2015,1.0,0.0
6587,Icaros: A Vision,5510,5510,0,movies-2017.csv,2017,1.0,0.0
6588,The Man from Earth: Holocene,5472,5472,0,movies-2017.csv,2017,1.0,0.0
6589,Cuban Food Stories,5434,5434,0,movies-2018.csv,2018,1.0,0.0
6590,Flex Is Kings,5418,5418,0,movies-2014.csv,2014,1.0,0.0
6591,The Only Real Game,5384,5384,0,movies-2014.csv,2014,1.0,0.0
6592,She's Lost Control,5319,5319,0,movies-2015.csv,2015,1.0,0.0
6593,The Time Being,5274,5274,0,movies-2013.csv,2013,1.0,0.0
6594,It's Not Yet Dark,5269,1227,4042,movies-2017.csv,2017,0.2328715126209907,0.7671284873790093
6595,Still Here,5268,5268,0,movies-2020.csv,2020,1.0,0.0
6596,Killers,5248,0,5248,movies-2014.csv,2014,0.0,1.0
6597,Sarajevo,5247,5247,0,movies-2015.csv,2015,1.0,0.0
6598,The Princess of France,5212,5212,0,movies-2015.csv,2015,1.0,0.0
6599,Death Valley,5211,5211,0,movies-2015.csv,2015,1.0,0.0
6600,In Searching,5210,5210,0,movies-2018.csv,2018,1.0,0.0
6601,Chokehold,5200,5200,0,movies-2019.csv,2019,1.0,0.0
6602,The Gliksmans,5166,5166,0,movies-2019.csv,2019,1.0,0.0
6603,And They're Off,5154,5154,0,movies-2011.csv,2011,1.0,0.0
6604,100 Acres of Hell,5152,5152,0,movies-2019.csv,2019,1.0,0.0
6605,Body at Brighton Rock,5123,5123,0,movies-2019.csv,2019,1.0,0.0
6606,Return to Nuke 'Em High Volume 1,5122,5122,0,movies-2014.csv,2014,1.0,0.0
6607,Intersection,5116,5116,0,movies-2018.csv,2018,1.0,0.0
6608,Bad Lucky Goat,5088,5088,0,movies-2017.csv,2017,1.0,0.0
6609,On War 2015 Re-release,5086,5086,0,movies-2015.csv,2015,1.0,0.0
6610,Welcome to Happiness,5083,5083,0,movies-2016.csv,2016,1.0,0.0
6611,2307: Winter's Dream,5078,0,5078,movies-2017.csv,2017,0.0,1.0
6612,Bidder 70,5074,5074,0,movies-2013.csv,2013,1.0,0.0
6613,Tanner Hall,5073,5073,0,movies-2011.csv,2011,1.0,0.0
6614,Notes on an Appearance,5065,5065,0,movies-2018.csv,2018,1.0,0.0
6615,Chulas Fronteras,5021,5021,0,movies-2019.csv,2019,1.0,0.0
6616,The Sleepwalker,5012,5012,0,movies-2014.csv,2014,1.0,0.0
6617,The Texture of Falling,5010,5010,0,movies-2018.csv,2018,1.0,0.0
6618,Downtown Express,5010,5010,0,movies-2012.csv,2012,1.0,0.0
6619,Social Animals,5007,5007,0,movies-2018.csv,2018,1.0,0.0
6620,The Garden,5006,5006,0,movies-2019.csv,2019,1.0,0.0
6621,An L.A. Minute,5004,5004,0,movies-2018.csv,2018,1.0,0.0
6622,Newlyweds,5000,5000,0,movies-2012.csv,2012,1.0,0.0
6623,Weekend of a Champion,4976,4100,876,movies-2013.csv,2013,0.8239549839228296,0.1760450160771704
6624,Bringing Up Bobby,4975,4975,0,movies-2012.csv,2012,1.0,0.0
6625,Ottolenghi and the Cakes of Versailles,4962,4962,0,movies-2020.csv,2020,1.0,0.0
6626,sxtape,4961,0,4961,movies-2014.csv,2014,0.0,1.0
6627,Futaba kara tooku hanarete,4960,4960,0,movies-2013.csv,2013,1.0,0.0
6628,Herman's House,4956,4956,0,movies-2013.csv,2013,1.0,0.0
6629,To Die Like a Man,4955,4029,926,movies-2011.csv,2011,0.8131180625630676,0.1868819374369324
6630,SBK: The Movie,4950,4950,0,movies-2015.csv,2015,1.0,0.0
6631,Tournament,4942,4942,0,movies-2017.csv,2017,1.0,0.0
6632,Company Town,4934,4934,0,movies-2017.csv,2017,1.0,0.0
6633,Supporting Characters,4917,4917,0,movies-2013.csv,2013,1.0,0.0
6634,Guidance,4900,4900,0,movies-2015.csv,2015,1.0,0.0
6635,Malek,4898,4898,0,movies-2019.csv,2019,1.0,0.0
6636,Revelation Road 2: The Sea of Glass and Fire,4871,4871,0,movies-2013.csv,2013,1.0,0.0
6637,Nothing Bad Can Happen,4870,4870,0,movies-2014.csv,2014,1.0,0.0
6638,Crepitus,4846,4846,0,movies-2019.csv,2019,1.0,0.0
6639,Call Her Applebroog,4842,4842,0,movies-2016.csv,2016,1.0,0.0
6640,Ballet Blanc,4832,4832,0,movies-2019.csv,2019,1.0,0.0
6641,Ferlinghetti: A Rebirth of Wonder,4816,4816,0,movies-2013.csv,2013,1.0,0.0
6642,"Half The Road: The Passion, Pitfalls & Power of Women's Professional Cycling",4783,4783,0,movies-2014.csv,2014,1.0,0.0
6643,Behind the White Glasses,4770,2223,2547,movies-2016.csv,2016,0.4660377358490566,0.5339622641509434
6644,Miss Hill: Making Dance Matter,4706,4706,0,movies-2015.csv,2015,1.0,0.0
6645,Shot,4701,4701,0,movies-2017.csv,2017,1.0,0.0
6646,Marinoni: The Fire in the Frame,4696,4696,0,movies-2016.csv,2016,1.0,0.0
6647,The Other Side of Everything,4685,4685,0,movies-2018.csv,2018,1.0,0.0
6648,Death Metal Angola,4674,4674,0,movies-2014.csv,2014,1.0,0.0
6649,The Long Dumb Road,4667,4667,0,movies-2018.csv,2018,1.0,0.0
6650,Blood on the Mountain,4664,4664,0,movies-2016.csv,2016,1.0,0.0
6651,Night School,4663,4663,0,movies-2017.csv,2017,1.0,0.0
6652,I Love You Both,4661,4661,0,movies-2017.csv,2017,1.0,0.0
6653,Shakespeare-Wallah,4650,4650,0,movies-2017.csv,2017,1.0,0.0
6654,Against the Sun,4646,4646,0,movies-2015.csv,2015,1.0,0.0
6655,Seeds of Time,4630,4630,0,movies-2015.csv,2015,1.0,0.0
6656,Miss Stevens,4611,4611,0,movies-2016.csv,2016,1.0,0.0
6657,The Automatic Hate,4603,4603,0,movies-2016.csv,2016,1.0,0.0
6658,Search Party 2016 Re-release,4571,4571,0,movies-2016.csv,2016,1.0,0.0
6659,Smiling Through the Apocalypse,4560,4560,0,movies-2014.csv,2014,1.0,0.0
6660,All Is Bright,4556,4556,0,movies-2013.csv,2013,1.0,0.0
6661,A Boy Called Po,4550,4550,0,movies-2017.csv,2017,1.0,0.0
6662,Here Comes the Devil,4534,4534,0,movies-2013.csv,2013,1.0,0.0
6663,Weightless,4530,4461,69,movies-2018.csv,2018,0.9847682119205298,0.015231788079470199
6664,Unrelated 2014 Re-release,4529,4529,0,movies-2014.csv,2014,1.0,0.0
6665,Synchronicity,4505,4505,0,movies-2016.csv,2016,1.0,0.0
6666,The Pulitzer at 100,4489,4489,0,movies-2017.csv,2017,1.0,0.0
6667,I'm Leaving Now,4488,4488,0,movies-2019.csv,2019,1.0,0.0
6668,German Concentration Camps Factual Survey,4468,4468,0,movies-2017.csv,2017,1.0,0.0
6669,"Farewell, Herr Schwarz",4445,4445,0,movies-2015.csv,2015,1.0,0.0
6670,Generation Iron 2,4439,4439,0,movies-2017.csv,2017,1.0,0.0
6671,SGT. Will Gardner,4405,4405,0,movies-2019.csv,2019,1.0,0.0
6672,The Truth About Emanuel,4404,4404,0,movies-2014.csv,2014,1.0,0.0
6673,The Peacemaker,4400,4400,0,movies-2018.csv,2018,1.0,0.0
6674,30-LOVE,4392,4392,0,movies-2017.csv,2017,1.0,0.0
6675,Between Us,4380,4380,0,movies-2013.csv,2013,1.0,0.0
6676,The End of Time,4375,4375,0,movies-2013.csv,2013,1.0,0.0
6677,The Catechism Cataclysm,4373,4373,0,movies-2011.csv,2011,1.0,0.0
6678,The Woman Who Left,4373,3974,399,movies-2017.csv,2017,0.9087582895037731,0.09124171049622684
6679,The Party's Just Beginning,4371,4145,226,movies-2018.csv,2018,0.9482955845344315,0.05170441546556852
6680,Tito and the Birds,4332,4332,0,movies-2019.csv,2019,1.0,0.0
6681,On Meditation,4322,4322,0,movies-2016.csv,2016,1.0,0.0
6682,Days of Grace 2015 Re-release,4308,4308,0,movies-2015.csv,2015,1.0,0.0
6683,The Tower,4305,1117,3188,movies-2014.csv,2014,0.259465737514518,0.740534262485482
6684,Auto Shop of Horrors,4300,4300,0,movies-2016.csv,2016,1.0,0.0
6685,The Fate of Lee Khan,4295,4295,0,movies-2019.csv,2019,1.0,0.0
6686,Art Is... The Permanent Revolution,4291,4291,0,movies-2012.csv,2012,1.0,0.0
6687,State Like Sleep,4282,4282,0,movies-2019.csv,2019,1.0,0.0
6688,Set Fire to the Stars,4280,4280,0,movies-2015.csv,2015,1.0,0.0
6689,The Knife of Don Juan,4254,4254,0,movies-2015.csv,2015,1.0,0.0
6690,My Father Die,4252,4252,0,movies-2017.csv,2017,1.0,0.0
6691,Cocote,4224,3815,409,movies-2018.csv,2018,0.9031723484848485,0.09682765151515152
6692,Maximum Ride,4218,4218,0,movies-2016.csv,2016,1.0,0.0
6693,Stella's Last Weekend,4215,4215,0,movies-2018.csv,2018,1.0,0.0
6694,Breaking a Monster,4212,4212,0,movies-2016.csv,2016,1.0,0.0
6695,Free the Nipple,4198,4198,0,movies-2014.csv,2014,1.0,0.0
6696,Among the Believers,4189,4189,0,movies-2016.csv,2016,1.0,0.0
6697,3 Geezers!,4175,4175,0,movies-2013.csv,2013,1.0,0.0
6698,Daylight,4171,4171,0,movies-2011.csv,2011,1.0,0.0
6699,Badsville,4153,4153,0,movies-2017.csv,2017,1.0,0.0
6700,Pawn,4141,4141,0,movies-2013.csv,2013,1.0,0.0
6701,Chinese Portrait,4140,4140,0,movies-2019.csv,2019,1.0,0.0
6702,Contracted,4105,4105,0,movies-2013.csv,2013,1.0,0.0
6703,Jason Becker: Not Dead Yet,4080,1294,2786,movies-2012.csv,2012,0.317156862745098,0.682843137254902
6704,Silver Circle,4080,4080,0,movies-2013.csv,2013,1.0,0.0
6705,Three Night Stand,4076,4076,0,movies-2015.csv,2015,1.0,0.0
6706,The Kitchen,4054,4054,0,movies-2013.csv,2013,1.0,0.0
6707,La Flor,4032,4032,0,movies-2019.csv,2019,1.0,0.0
6708,Morning,4029,4029,0,movies-2013.csv,2013,1.0,0.0
6709,Approved for Adoption 2013 Re-release,4015,4015,0,movies-2013.csv,2013,1.0,0.0
6710,Yangsi,4008,4008,0,movies-2012.csv,2012,1.0,0.0
6711,Campus Radio,4000,4000,0,movies-2011.csv,2011,1.0,0.0
6712,Pickin' & Grinnin',4000,4000,0,movies-2012.csv,2012,1.0,0.0
6713,Building Hope,4000,4000,0,movies-2011.csv,2011,1.0,0.0
6714,Emily,3982,3982,0,movies-2017.csv,2017,1.0,0.0
6715,Dream Boat,3981,3981,0,movies-2017.csv,2017,1.0,0.0
6716,Armed,3948,3948,0,movies-2018.csv,2018,1.0,0.0
6717,Mother of a Day,3919,3919,0,movies-2019.csv,2019,1.0,0.0
6718,Maidan,3909,3909,0,movies-2014.csv,2014,1.0,0.0
6719,American Dresser,3895,3895,0,movies-2018.csv,2018,1.0,0.0
6720,The Iron Ministry,3885,3340,545,movies-2015.csv,2015,0.8597168597168597,0.1402831402831403
6721,Crown Vic,3868,3868,0,movies-2019.csv,2019,1.0,0.0
6722,Hollidaysburg,3861,3861,0,movies-2014.csv,2014,1.0,0.0
6723,The Second Time Around,3837,3837,0,movies-2018.csv,2018,1.0,0.0
6724,"High Tech, Low Life",3836,3836,0,movies-2013.csv,2013,1.0,0.0
6725,King's Gambit,3816,3816,0,movies-2020.csv,2020,1.0,0.0
6726,Free Radicals: A History of Experimental Film,3804,3804,0,movies-2012.csv,2012,1.0,0.0
6727,Wallflower,3801,3801,0,movies-2019.csv,2019,1.0,0.0
6728,Unfreedom,3778,3778,0,movies-2015.csv,2015,1.0,0.0
6729,They Come to America,3775,3775,0,movies-2012.csv,2012,1.0,0.0
6730,The Gender Card Flip,3774,3774,0,movies-2017.csv,2017,1.0,0.0
6731,The Hollow,3755,3755,0,movies-2016.csv,2016,1.0,0.0
6732,Nelly,3751,3751,0,movies-2018.csv,2018,1.0,0.0
6733,Bugs,3742,3742,0,movies-2017.csv,2017,1.0,0.0
6734,Bad Blood,3731,3731,0,movies-2012.csv,2012,1.0,0.0
6735,The Free Speech Apocalypse,3726,3726,0,movies-2015.csv,2015,1.0,0.0
6736,The Condemned,3718,3718,0,movies-2013.csv,2013,1.0,0.0
6737,The Harvest/La Cosecha,3709,3709,0,movies-2011.csv,2011,1.0,0.0
6738,The Family,3696,3696,0,movies-2018.csv,2018,1.0,0.0
6739,The Word,3648,3648,0,movies-2014.csv,2014,1.0,0.0
6740,Stop The Pounding Heart,3642,3642,0,movies-2014.csv,2014,1.0,0.0
6741,The Wandering Soap Opera,3624,3624,0,movies-2019.csv,2019,1.0,0.0
6742,Mr. Nobody 2013 Re-release,3622,3622,0,movies-2013.csv,2013,1.0,0.0
6743,Hyena,3586,3401,185,movies-2015.csv,2015,0.9484104852203011,0.05158951477969883
6744,Hide Your Smiling Faces,3576,3576,0,movies-2014.csv,2014,1.0,0.0
6745,Evolution of a Criminal,3568,3568,0,movies-2014.csv,2014,1.0,0.0
6746,The Last Film Festival,3558,3558,0,movies-2016.csv,2016,1.0,0.0
6747,Fourplay,3550,3550,0,movies-2018.csv,2018,1.0,0.0
6748,The Beautiful Troublemaker 2017 Re-release,3540,3540,0,movies-2017.csv,2017,1.0,0.0
6749,Tricked,3533,3533,0,movies-2013.csv,2013,1.0,0.0
6750,The Loving Story 2016 Re-release,3518,3518,0,movies-2016.csv,2016,1.0,0.0
6751,Who's Crazy?,3497,3497,0,movies-2017.csv,2017,1.0,0.0
6752,Locker 13,3496,3496,0,movies-2014.csv,2014,1.0,0.0
6753,The Citizen 2018 Re-release,3495,3495,0,movies-2018.csv,2018,1.0,0.0
6754,"Love, Sweat and Tears",3482,3482,0,movies-2017.csv,2017,1.0,0.0
6755,The Hacker Wars,3470,3470,0,movies-2014.csv,2014,1.0,0.0
6756,Aftermath,3451,3451,0,movies-2014.csv,2014,1.0,0.0
6757,Life's a Breeze 2014 Re-release,3450,3450,0,movies-2014.csv,2014,1.0,0.0
6758,Scenic Route,3434,3434,0,movies-2013.csv,2013,1.0,0.0
6759,Mahogany Sunrise,3432,3432,0,movies-2014.csv,2014,1.0,0.0
6760,Restored Me 2016 Re-release,3428,3428,0,movies-2016.csv,2016,1.0,0.0
6761,Speed Sisters,3423,3423,0,movies-2017.csv,2017,1.0,0.0
6762,The Happy Poet,3400,3400,0,movies-2013.csv,2013,1.0,0.0
6763,The Cage Fighter,3392,3392,0,movies-2018.csv,2018,1.0,0.0
6764,Rottentail,3383,3383,0,movies-2019.csv,2019,1.0,0.0
6765,Amanda & Jack Go Glamping,3352,3352,0,movies-2017.csv,2017,1.0,0.0
6766,Bad Match,3351,3351,0,movies-2017.csv,2017,1.0,0.0
6767,Followers,3350,3350,0,movies-2018.csv,2018,1.0,0.0
6768,Swerve,3338,3338,0,movies-2013.csv,2013,1.0,0.0
6769,Mi America,3330,3330,0,movies-2015.csv,2015,1.0,0.0
6770,Know How,3323,3323,0,movies-2015.csv,2015,1.0,0.0
6771,Drunk Wedding,3301,3301,0,movies-2015.csv,2015,1.0,0.0
6772,Burning Bodhi,3289,3289,0,movies-2016.csv,2016,1.0,0.0
6773,Axe Giant: The Wrath of Paul Bunyan,3287,3287,0,movies-2013.csv,2013,1.0,0.0
6774,Justice,3259,3259,0,movies-2017.csv,2017,1.0,0.0
6775,Windsor Drive,3256,3256,0,movies-2015.csv,2015,1.0,0.0
6776,Over the Limit,3243,3243,0,movies-2018.csv,2018,1.0,0.0
6777,The Sons of Tennessee Williams,3242,3242,0,movies-2011.csv,2011,1.0,0.0
6778,As Cool as I Am,3234,3234,0,movies-2013.csv,2013,1.0,0.0
6779,Blackhats,3216,3216,0,movies-2015.csv,2015,1.0,0.0
6780,After the Wizard,3184,3184,0,movies-2012.csv,2012,1.0,0.0
6781,Apart,3161,3161,0,movies-2012.csv,2012,1.0,0.0
6782,Game Changers,3142,3142,0,movies-2018.csv,2018,1.0,0.0
6783,Balls to the Wall,3140,3140,0,movies-2011.csv,2011,1.0,0.0
6784,Hot to Trot,3133,3133,0,movies-2018.csv,2018,1.0,0.0
6785,The Girl on the Train,3124,3124,0,movies-2014.csv,2014,1.0,0.0
6786,Showrunners,3100,3100,0,movies-2014.csv,2014,1.0,0.0
6787,What Now? Remind Me,3089,3089,0,movies-2014.csv,2014,1.0,0.0
6788,Drew: The Man Behind the Poster,3078,3078,0,movies-2013.csv,2013,1.0,0.0
6789,Chasing Portraits,3076,3076,0,movies-2019.csv,2019,1.0,0.0
6790,The Weird World of Blowfly,3062,3062,0,movies-2011.csv,2011,1.0,0.0
6791,A French Gigolo 2014 Re-release,3021,3021,0,movies-2014.csv,2014,1.0,0.0
6792,A Girl and a Gun,3018,3018,0,movies-2013.csv,2013,1.0,0.0
6793,Best and Most Beautiful Things,3016,3016,0,movies-2016.csv,2016,1.0,0.0
6794,Zokkomon,3000,3000,0,movies-2011.csv,2011,1.0,0.0
6795,Fatal Assistance,3000,3000,0,movies-2014.csv,2014,1.0,0.0
6796,The Ghosts of Johnson Woods,3000,3000,0,movies-2016.csv,2016,1.0,0.0
6797,The Lie,3000,3000,0,movies-2011.csv,2011,1.0,0.0
6798,Moana,2993,2993,0,movies-2015.csv,2015,1.0,0.0
6799,Kepler's Dream,2923,2923,0,movies-2017.csv,2017,1.0,0.0
6800,Demons,2900,2900,0,movies-2017.csv,2017,1.0,0.0
6801,The Professor: Tai Chi's Journey West,2852,2852,0,movies-2016.csv,2016,1.0,0.0
6802,Approaching Midnight,2795,2795,0,movies-2013.csv,2013,1.0,0.0
6803,Nana,2784,2784,0,movies-2018.csv,2018,1.0,0.0
6804,Blood Ties,2760,2760,0,movies-2011.csv,2011,1.0,0.0
6805,White Lies 2016 Re-release,2760,2760,0,movies-2016.csv,2016,1.0,0.0
6806,I Dream in Another Language,2739,2739,0,movies-2017.csv,2017,1.0,0.0
6807,Black Out 2014 Re-release,2734,2734,0,movies-2014.csv,2014,1.0,0.0
6808,The Lesser Blessed,2732,2732,0,movies-2013.csv,2013,1.0,0.0
6809,Chocolat 2015 Re-release,2710,2710,0,movies-2015.csv,2015,1.0,0.0
6810,Julia,2710,2710,0,movies-2015.csv,2015,1.0,0.0
6811,Back to the Fatherland,2697,2697,0,movies-2019.csv,2019,1.0,0.0
6812,Straight Into a Storm,2684,2684,0,movies-2018.csv,2018,1.0,0.0
6813,Santoalla,2684,2684,0,movies-2017.csv,2017,1.0,0.0
6814,Division 19,2680,1699,981,movies-2019.csv,2019,0.633955223880597,0.366044776119403
6815,Restitution,2664,2664,0,movies-2011.csv,2011,1.0,0.0
6816,United Red Army 2011 Re-release,2659,2659,0,movies-2011.csv,2011,1.0,0.0
6817,Bang! Bang!,2658,2658,0,movies-2020.csv,2020,1.0,0.0
6818,Daughter of the Nile,2640,2640,0,movies-2017.csv,2017,1.0,0.0
6819,Body,2634,2634,0,movies-2015.csv,2015,1.0,0.0
6820,Refuge,2631,2631,0,movies-2014.csv,2014,1.0,0.0
6821,Indigo Children,2621,2621,0,movies-2014.csv,2014,1.0,0.0
6822,ACORN and the Firestorm,2621,2621,0,movies-2018.csv,2018,1.0,0.0
6823,Sparrows Dance,2602,2602,0,movies-2013.csv,2013,1.0,0.0
6824,Last Flight of the Champion,2597,2597,0,movies-2013.csv,2013,1.0,0.0
6825,Jake Squared,2592,2592,0,movies-2014.csv,2014,1.0,0.0
6826,Carl,2592,2592,0,movies-2012.csv,2012,1.0,0.0
6827,Hammer of the Gods,2590,641,1949,movies-2013.csv,2013,0.24749034749034748,0.7525096525096525
6828,Take Me,2583,2583,0,movies-2017.csv,2017,1.0,0.0
6829,McCanick,2572,2572,0,movies-2014.csv,2014,1.0,0.0
6830,Hayride 2,2571,2571,0,movies-2015.csv,2015,1.0,0.0
6831,Joan the Maid 1: The Battles,2562,2562,0,movies-2019.csv,2019,1.0,0.0
6832,Cassadaga,2544,2544,0,movies-2013.csv,2013,1.0,0.0
6833,Two-Bit Waltz,2540,2540,0,movies-2014.csv,2014,1.0,0.0
6834,Miles,2537,2537,0,movies-2017.csv,2017,1.0,0.0
6835,Almost in Love,2510,2510,0,movies-2013.csv,2013,1.0,0.0
6836,Mekong Hotel,2502,2502,0,movies-2016.csv,2016,1.0,0.0
6837,The Last Day of August,2492,2492,0,movies-2013.csv,2013,1.0,0.0
6838,Homeland (Iraq Year Zero),2491,2491,0,movies-2016.csv,2016,1.0,0.0
6839,Men at Lunch,2483,2483,0,movies-2013.csv,2013,1.0,0.0
6840,The Wait,2480,2480,0,movies-2014.csv,2014,1.0,0.0
6841,TINY: The Life of Erin Blackwell,2465,2465,0,movies-2019.csv,2019,1.0,0.0
6842,The Ghastly Love of Johnny X,2436,2436,0,movies-2012.csv,2012,1.0,0.0
6843,Why Stop Now?,2432,2432,0,movies-2012.csv,2012,1.0,0.0
6844,The Reflektor Tapes,2424,0,2424,movies-2015.csv,2015,0.0,1.0
6845,L.A. Slasher,2421,2421,0,movies-2015.csv,2015,1.0,0.0
6846,Ek Hazarachi Note,2404,2404,0,movies-2016.csv,2016,1.0,0.0
6847,Moondance,2371,2371,0,movies-2020.csv,2020,1.0,0.0
6848,Evergreen: The Road to Legalization,2363,2363,0,movies-2014.csv,2014,1.0,0.0
6849,I Lost Albert 2019 Re-release,2354,2354,0,movies-2019.csv,2019,1.0,0.0
6850,A German Youth,2343,2343,0,movies-2019.csv,2019,1.0,0.0
6851,Detective Chinatown 3,2342,0,2342,movies-2020.csv,2020,0.0,1.0
6852,Lotus Eaters,2325,2325,0,movies-2013.csv,2013,1.0,0.0
6853,The Happy House,2311,2311,0,movies-2013.csv,2013,1.0,0.0
6854,Goldie,2302,2302,0,movies-2020.csv,2020,1.0,0.0
6855,Serendipity,2298,2298,0,movies-2019.csv,2019,1.0,0.0
6856,The Pool Boys,2269,2269,0,movies-2011.csv,2011,1.0,0.0
6857,Red Christmas,2255,2255,0,movies-2017.csv,2017,1.0,0.0
6858,Anita Ho,2250,2250,0,movies-2015.csv,2015,1.0,0.0
6859,Memoria,2242,2242,0,movies-2016.csv,2016,1.0,0.0
6860,The Night Watchman,2219,2219,0,movies-2012.csv,2012,1.0,0.0
6861,7 from Etheria,2208,2208,0,movies-2017.csv,2017,1.0,0.0
6862,InSpectres,2207,2207,0,movies-2013.csv,2013,1.0,0.0
6863,Scorn,2206,2206,0,movies-2012.csv,2012,1.0,0.0
6864,Missionary,2120,2120,0,movies-2014.csv,2014,1.0,0.0
6865,Me You and Five Bucks,2105,2105,0,movies-2015.csv,2015,1.0,0.0
6866,Jihadists,2104,2104,0,movies-2019.csv,2019,1.0,0.0
6867,Dayveon,2077,2077,0,movies-2017.csv,2017,1.0,0.0
6868,Rubberneck,2075,2075,0,movies-2013.csv,2013,1.0,0.0
6869,Red Flag,2075,2075,0,movies-2013.csv,2013,1.0,0.0
6870,Patagonia Rising,2064,2064,0,movies-2012.csv,2012,1.0,0.0
6871,The Transcendents,2041,2041,0,movies-2020.csv,2020,1.0,0.0
6872,Gul Makai,2035,0,2035,movies-2020.csv,2020,0.0,1.0
6873,Algorithms,2021,2021,0,movies-2014.csv,2014,1.0,0.0
6874,Split: A Deeper Divide,2000,2000,0,movies-2012.csv,2012,1.0,0.0
6875,The Watermelon Woman,1989,1989,0,movies-2016.csv,2016,1.0,0.0
6876,"Accidental Courtesy: Daryl Davis, Race & America",1940,1940,0,movies-2017.csv,2017,1.0,0.0
6877,Best Man Down,1938,1938,0,movies-2013.csv,2013,1.0,0.0
6878,West Of The Jordan River,1926,1926,0,movies-2018.csv,2018,1.0,0.0
6879,Sneakerheadz,1903,1903,0,movies-2015.csv,2015,1.0,0.0
6880,We Were Here,1873,0,1873,movies-2011.csv,2011,0.0,1.0
6881,Finding Happiness,1841,1841,0,movies-2018.csv,2018,1.0,0.0
6882,Jimi Hendrix Electric Church,1818,0,1818,movies-2019.csv,2019,0.0,1.0
6883,Now & Later,1808,1808,0,movies-2011.csv,2011,1.0,0.0
6884,I Kissed a Vampire,1794,1794,0,movies-2012.csv,2012,1.0,0.0
6885,Detour,1788,1788,0,movies-2017.csv,2017,1.0,0.0
6886,The Shade Shepherd,1781,1781,0,movies-2020.csv,2020,1.0,0.0
6887,The Lost Village,1780,1780,0,movies-2018.csv,2018,1.0,0.0
6888,Detention of the Dead,1777,1777,0,movies-2013.csv,2013,1.0,0.0
6889,The Other Man: F.W. de Klerk and the End of Apartheid,1747,1747,0,movies-2015.csv,2015,1.0,0.0
6890,Dark Forest,1739,1739,0,movies-2015.csv,2015,1.0,0.0
6891,You Don't Need Feet to Dance,1719,1719,0,movies-2013.csv,2013,1.0,0.0
6892,A Beautiful Now,1714,1714,0,movies-2016.csv,2016,1.0,0.0
6893,The Looking Glass,1711,1711,0,movies-2015.csv,2015,1.0,0.0
6894,Dystopia: 2013,1708,1708,0,movies-2012.csv,2012,1.0,0.0
6895,More Than the Rainbow,1677,1677,0,movies-2014.csv,2014,1.0,0.0
6896,They're Out of the Business,1655,1655,0,movies-2011.csv,2011,1.0,0.0
6897,Drown,1631,1631,0,movies-2015.csv,2015,1.0,0.0
6898,Cut Snake,1625,1625,0,movies-2015.csv,2015,1.0,0.0
6899,Game Day,1624,1624,0,movies-2019.csv,2019,1.0,0.0
6900,Forever,1598,1598,0,movies-2015.csv,2015,1.0,0.0
6901,Miss India America,1598,1598,0,movies-2016.csv,2016,1.0,0.0
6902,American Playhouse: The Killing Floor,1583,1583,0,movies-2019.csv,2019,1.0,0.0
6903,The Fox Hunter,1577,1577,0,movies-2020.csv,2020,1.0,0.0
6904,The Tunnel,1532,1532,0,movies-2011.csv,2011,1.0,0.0
6905,Rhymes for Young Ghouls,1529,1529,0,movies-2014.csv,2014,1.0,0.0
6906,Souldier,1500,1500,0,movies-2014.csv,2014,1.0,0.0
6907,Where Are You Taking Me?,1492,1492,0,movies-2012.csv,2012,1.0,0.0
6908,Making Rounds,1484,1484,0,movies-2015.csv,2015,1.0,0.0
6909,The Package,1469,1469,0,movies-2013.csv,2013,1.0,0.0
6910,Henchmen,1469,1469,0,movies-2018.csv,2018,1.0,0.0
6911,That Way Madness Lies...,1447,1447,0,movies-2018.csv,2018,1.0,0.0
6912,Bestiaire,1428,1428,0,movies-2012.csv,2012,1.0,0.0
6913,The Silence of Mark Rothko,1422,1422,0,movies-2016.csv,2016,1.0,0.0
6914,The Forest for the Trees,1410,1410,0,movies-2017.csv,2017,1.0,0.0
6915,Beauty and the Beholder,1368,1368,0,movies-2018.csv,2018,1.0,0.0
6916,Along the Roadside 2015 Re-release,1352,1352,0,movies-2015.csv,2015,1.0,0.0
6917,3 Nights in the Desert,1297,1297,0,movies-2015.csv,2015,1.0,0.0
6918,The Hours and Times,1273,1273,0,movies-2019.csv,2019,1.0,0.0
6919,Altered Perception,1259,1259,0,movies-2018.csv,2018,1.0,0.0
6920,The Wolf Hour,1255,0,1255,movies-2019.csv,2019,0.0,1.0
6921,A Fish in the Bathtub 2019 re-release,1237,1237,0,movies-2019.csv,2019,1.0,0.0
6922,Two Men Went to War 2018 Re-release,1227,1227,0,movies-2018.csv,2018,1.0,0.0
6923,A Small Good Thing,1196,1196,0,movies-2016.csv,2016,1.0,0.0
6924,Snowman's Land,1190,1190,0,movies-2012.csv,2012,1.0,0.0
6925,Under the Turban,1190,1190,0,movies-2018.csv,2018,1.0,0.0
6926,Above and Below,1189,0,1189,movies-2016.csv,2016,0.0,1.0
6927,A Different American Dream,1172,1172,0,movies-2017.csv,2017,1.0,0.0
6928,A Zombie Invasion,1170,1170,0,movies-2013.csv,2013,1.0,0.0
6929,Fear Pharm,1157,1157,0,movies-2020.csv,2020,1.0,0.0
6930,Jack & Diane,1142,1142,0,movies-2012.csv,2012,1.0,0.0
6931,The Father,1141,0,1141,movies-2020.csv,2020,0.0,1.0
6932,Veer!,1132,1132,0,movies-2013.csv,2013,1.0,0.0
6933,Hai Tang Hong,1107,1107,0,movies-2020.csv,2020,1.0,0.0
6934,Half Brothers,1100,1100,0,movies-2018.csv,2018,1.0,0.0
6935,We Are the Giant,1088,1088,0,movies-2014.csv,2014,1.0,0.0
6936,The Butterfly Room,1081,1081,0,movies-2014.csv,2014,1.0,0.0
6937,Childless,1036,1036,0,movies-2015.csv,2015,1.0,0.0
6938,Invisible Hands,1034,1034,0,movies-2018.csv,2018,1.0,0.0
6939,Absence,1031,1031,0,movies-2013.csv,2013,1.0,0.0
6940,Remnants,1022,1022,0,movies-2013.csv,2013,1.0,0.0
6941,The Penguin Counters,976,976,0,movies-2017.csv,2017,1.0,0.0
6942,Strangers Online,968,968,0,movies-2011.csv,2011,1.0,0.0
6943,A People Uncounted,930,930,0,movies-2014.csv,2014,1.0,0.0
6944,They Are We,900,900,0,movies-2015.csv,2015,1.0,0.0
6945,Big Muddy,881,881,0,movies-2015.csv,2015,1.0,0.0
6946,Extraordinary Ordinary People,880,880,0,movies-2017.csv,2017,1.0,0.0
6947,Officer Downe,850,850,0,movies-2016.csv,2016,1.0,0.0
6948,Abandoned,832,832,0,movies-2011.csv,2011,1.0,0.0
6949,TVTV: Video Revolutionaries,812,812,0,movies-2018.csv,2018,1.0,0.0
6950,Jackpot 2014 Re-release,806,806,0,movies-2014.csv,2014,1.0,0.0
6951,The Untold Story,790,790,0,movies-2019.csv,2019,1.0,0.0
6952,It's All So Quiet 2015 Re-release,724,724,0,movies-2015.csv,2015,1.0,0.0
6953,A Girl Like Grace,713,713,0,movies-2016.csv,2016,1.0,0.0
6954,Redneck Carnage,706,706,0,movies-2011.csv,2011,1.0,0.0
6955,The Loving Story,700,700,0,movies-2012.csv,2012,1.0,0.0
6956,It's Hard Being Loved by Jerks 2015 Re-release,697,697,0,movies-2015.csv,2015,1.0,0.0
6957,The Portal,685,0,685,movies-2019.csv,2019,0.0,1.0
6958,Syrup,663,663,0,movies-2013.csv,2013,1.0,0.0
6959,Nature Calls,646,646,0,movies-2012.csv,2012,1.0,0.0
6960,Citizen Gangster,625,625,0,movies-2012.csv,2012,1.0,0.0
6961,Gottfried Helnwein and the Dreaming Child,601,601,0,movies-2012.csv,2012,1.0,0.0
6962,A Good Day to Die,573,573,0,movies-2011.csv,2011,1.0,0.0
6963,The Pit,560,560,0,movies-2016.csv,2016,1.0,0.0
6964,Higher Power,528,528,0,movies-2018.csv,2018,1.0,0.0
6965,Greater 2020 Re-release,527,527,0,movies-2020.csv,2020,1.0,0.0
6966,Meeting Evil,525,525,0,movies-2012.csv,2012,1.0,0.0
6967,The 11th Hour,510,0,510,movies-2015.csv,2015,0.0,1.0
6968,Triumph of the Wall,476,476,0,movies-2013.csv,2013,1.0,0.0
6969,Green is Gold,455,455,0,movies-2016.csv,2016,1.0,0.0
6970,Skinless,400,400,0,movies-2014.csv,2014,1.0,0.0
6971,Cinemanovels,398,398,0,movies-2014.csv,2014,1.0,0.0
6972,Spaceship Earth,362,0,362,movies-2020.csv,2020,0.0,1.0
6973,Antiporno,294,0,294,movies-2017.csv,2017,0.0,1.0
6974,Wet Woman in the Wind,268,0,268,movies-2017.csv,2017,0.0,1.0
6975,"Mummy, I'm A Zombie",120,120,0,movies-2014.csv,2014,1.0,0.0
6976,Paranoid Girls,78,78,0,movies-2015.csv,2015,1.0,0.0
6977,Confession of a Child of the Century 2015 Re-release,74,74,0,movies-2015.csv,2015,1.0,0.0
